ニン	人
テキ	的
ネン	年
ニチ	日
ワタシ	私
モノ	者
ガツ	月
ナカ	中
ニッポン	日本
イチ	一
ナニ	何
オモイ	思い
ジブン	自分
ホウ	方
トキ	時
モンダイ	問題
ケン	見
イマ	今
カンガエル	考える
オモウ	思う
マエ	前
ダイ	第
セイ	性
ジカン	時間
カイ	会
エン	円
ニ	二
バアイ	場合
ヒツヨウ	必要
ジョウホウ	情報
カ	化
ウエ	上
コト	事
シュツ	出
ハナシ	話
ホン	本
フン	分
ジュウ	十
メ	目
カンジル	感じる
イウ	言う
キョウ	今日
カンケイ	関係
イイン	委員
ノチ	後
イエ	家
セカイ	世界
キ	気
テン	点
マン	万
シャカイ	社会
シゴト	仕事
オナジル	同じる
カズ	数
キジ	記事
オコナウ	行う
カレ	彼
ダイ	大
クニ	国
ナド	等
カイ	回
サン	三
クン	君
ホウ	法
イミ	意味
チカラ	力
イジョウ	以上
カイシャ	会社
モツ	持つ
ニンゲン	人間
オオク	多く
ライ	来
ゲンザイ	現在
キギョウ	企業
シ	氏
カン	間
カノウ	可能
ケンキュウ	研究
トウコウ	投稿
ホカ	他
コンカイ	今回
ツギ	次
コトバ	言葉
カイ	書い
ボク	僕
オオイ	多い
ケイザイ	経済
テ	手
サイキン	最近
ケッカ	結果
ド	度
エイガ	映画
センセイ	先生
セイカツ	生活
キン	金
イワ	言わ
ジダイ	時代
セイフ	政府
ヒジョウ	非常
オ	御
ミセ	店
ヨイ	良い
ナイヨウ	内容
ヒトツ	一つ
ココロ	心
ミル	見る
セツメイ	説明
シャシン	写真
キョウイク	教育
ジョセイ	女性
コドモ	子供
ホウホウ	方法
ニタイシテ	に対して
メイ	名
リヨウ	利用
スコシ	少し
ショウカイ	紹介
ギジュツ	技術
ナマエ	名前
サンカ	参加
イル	入る
オオキナ	大きな
ウケル	受ける
スキ	好き
カツドウ	活動
トウキョウ	東京
ジョウキョウ	状況
ゴ	五
ニタイスル	に対する
カンリ	管理
トクニ	特に
カンキョウ	環境
チイキ	地域
ホントウニ	本当に
ツカウ	使う
ジッサイ	実際
チュウゴク	中国
シ	市
サキ	先
キイ	聞い
ダレ	誰
コジン	個人
イケン	意見
ジョウタイ	状態
トシ	歳
ダイガク	大学
モノ	物
ソンザイ	存在
サイゴ	最後
ワライ	笑
カノジョ	彼女
リカイ	理解
ガッコウ	学校
ブブン	部分
エ	得
デンワ	電話
ヨウ	用
イク	行く
ブ	部
ケン	県
ニッキ	日記
セイド	制度
シヨウ	使用
ジギョウ	事業
シ	四
コテイ	固定
チョウサ	調査
キホン	基本
カンレン	関連
イッパン	一般
アタラシイ	新しい
カイハツ	開発
オンガク	音楽
イチバン	一番
ナイ	内
サクヒン	作品
ガワ	側
ジュウヨウ	重要
デキ	出来
タカイ	高い
サイショ	最初
サマ	様
トオル	達
コクミン	国民
ニカンスル	に関する
ダシ	出し
チョウ	長
ミズ	水
シン	新
ジケン	事件
エイゴ	英語
トコロ	所
シツモン	質問
カタチ	形
オトコ	男
ヤク	約
シュギ	主義
シタ	下
バ	場
ヨン	読ん
リユウ	理由
シラ	知ら
カキ	書
イレル	入れる
ハジメル	始める
シャ	社
バショ	場所
キノウ	機能
コメ	米
オネガイ	お願い
ロウドウ	労働
クルマ	車
タベル	食べる
アイテ	相手
コクサイ	国際
ジシン	自身
コエ	声
ケイカク	計画
セイジ	政治
ベツ	別
ケイ	系
カン	感
オモワ	思わ
オク	億
ゴロ	頃
ゴウ	号
ニホンジン	日本人
コンゴ	今後
イエル	言える
ブンカ	文化
カラダ	体
チガウ	違う
タイヘン	大変
カレラ	彼ら
ヒョウカ	評価
ヒャク	百
タイオウ	対応
ケン	権
アタマ	頭
コ	子
ジユウ	自由
シル	知る
キノウ	昨日
オコナワ	行わ
レキシ	歴史
ゼンタイ	全体
キモチ	気持ち
ホウコク	報告
テイド	程度
モト	元
ヒトビト	人々
イイ	言い
ヨテイ	予定
ダイヒョウ	代表
ソノノチ	その後
ケイケン	経験
カタ	型
イン	員
イガイ	以外
コンネン	今年
カカク	価格
トウシ	投資
ケイエイ	経営
ミエル	見える
シゼン	自然
ショウヒン	商品
ハッピョウ	発表
モクテキ	目的
エイキョウ	影響
チホウ	地方
イッショ	一緒
メン	面
カオ	顔
センシュ	選手
ナイ	無い
ミチ	道
コドモ	子ども
ジツハ	実は
タシカ	確か
チガイ	違い
セン	千
カクニン	確認
クダサイ	下さい
ヨル	夜
タトエバ	例えば
チュウシン	中心
シジョウ	市場
オト	音
テイキョウ	提供
ジジツ	事実
チ	地
カンタン	簡単
アサ	朝
ハン	版
ガク	学
トウゼン	当然
イカ	以下
セキニン	責任
サクス	作す
ロク	六
トウリ	通り
ギロン	議論
ツヅケル	続ける
イゼン	以前
クライ	位
カウ	買う
ハンダン	判断
レイ	例
センモン	専門
カゾク	家族
ムケル	向ける
ワルイ	悪い
ハジメテ	初めて
ベンキョウ	勉強
キタイ	期待
マッタク	全く
オシエル	教える
カンコク	韓国
ソト	外
コウカ	効果
ケントウ	検討
カク	各
フツウ	普通
ソシキ	組織
セイサク	政策
マチ	町
コウドウ	行動
ネンカン	年間
リツ	率
トウジ	当時
ガクセイ	学生
ウミ	海
ハンバイ	販売
コウニュウ	購入
カガク	科学
オヨビ	及び
カントク	監督
イシキ	意識
タカ	高
キュウ	九
セイサン	生産
ヒョウゲン	表現
センソウ	戦争
サンコウ	参考
ソノホカ	その他
ケッテイ	決定
キョク	曲
ドウ	同
ホウリツ	法律
キカン	機関
モウシアゲル	申し上げる
オオキク	大きく
イキ	行き
タイショウ	対象
ゲンジツ	現実
ヨム	読む
タイサク	対策
サギョウ	作業
カチ	価値
ジュウブン	十分
イチブ	一部
ゴ	語
スガタ	姿
シンブン	新聞
イッポウ	一方
カゼ	風
ハチ	八
キワ	際
ロン	論
スベテ	全て
ダイジン	大臣
カミ	神
コッカ	国家
ケン	件
マイニチ	毎日
オレ	俺
シアイ	試合
シチ	七
カイギ	会議
シテキ	指摘
カク	書く
セイヒン	製品
ヘンカ	変化
ケッキョク	結局
ショウヒ	消費
ホケン	保険
カン	観
グタイ	具体
ジンセイ	人生
リョウ	量
ベイコク	米国
ヒョウジ	表示
セイシン	精神
マチ	街
カコ	過去
ワレワレ	我々
チカク	近く
ノウリョク	能力
シドウ	指導
コウシン	更新
シイ	強い
コウカイ	公開
ニホンゴ	日本語
ミナサン	皆さん
ヤ	屋
オンナ	女
ムカシ	昔
タントウ	担当
ヒ	費
アシタ	明日
リョコウ	旅行
ユメ	夢
アキラカ	明らか
キ	木
キ	機
タイセツ	大切
キョク	局
モトメル	求める
ギョウセイ	行政
アンゼン	安全
ガイコク	外国
オキン	お金
シリョウ	資料
ヘヤ	部屋
コウイ	行為
ヘイセイ	平成
ショク	色
ムズカシイ	難しい
トウロク	登録
セッテイ	設定
セイコウ	成功
ドリョク	努力
セン	戦
ウマレル	生まれる
アタエル	与える
ダンタイ	団体
シエン	支援
モットモ	最も
ジコ	自己
ゼン	全
ネンド	年度
ウンドウ	運動
コウゾウ	構造
トクベツ	特別
カイケツ	解決
カンゼン	完全
ホシイ	欲しい
カギリ	限り
ヒン	品
ワケ	訳
イキル	生きる
ツカワ	使わ
ダンセイ	男性
ケッコウ	結構
デル	出る
サンギョウ	産業
グン	軍
シュ	主
ナガレル	流れる
デキル	出来る
ニカンシテ	に関して
ニンキ	人気
オハナシ	お話
スギル	過ぎる
エキ	駅
サイシュウ	最終
コタエル	答える
ホゴ	保護
サイ	再
ナマ	生
カイサイ	開催
ホウコウ	方向
カイカク	改革
ケンサク	検索
ワスレル	忘れる
ケンコウ	健康
ショウガイ	障害
ヶガツ	ヶ月
ミトメル	認める
キョウリョク	協力
ジキ	時期
リョウリ	料理
カンガエカタ	考え方
タノシミ	楽しみ
イリョウ	医療
キンユウ	金融
シケン	試験
タチバ	立場
ケイヤク	契約
ヨク	良く
ジョウケン	条件
ホウソウ	放送
ゼンコク	全国
シツ	室
マイ	枚
サクセイ	作成
アシ	足
セイチョウ	成長
シセツ	施設
クル	来る
トウジョウ	登場
チシキ	知識
ケイタイ	携帯
ジツゲン	実現
ユウジン	友人
ハヤク	早く
カイガイ	海外
ゲンイン	原因
ジッシ	実施
サクネン	昨年
ビョウイン	病院
ダイ	代
ニンシキ	認識
ナツ	夏
ダンカイ	段階
ハッセイ	発生
ハンタイ	反対
キカン	期間
ク	区
ジョウ	条
ゴゴ	午後
ゼイ	税
シュチョウ	主張
ヘンコウ	変更
カカ	書か
バングミ	番組
コンド	今度
イリ	入り
ツヅキ	続き
ジュンビ	準備
ノベル	述べる
ショリ	処理
クチ	口
シキ	式
ウゴキ	動き
ゼッタイ	絶対
カキ	書き
ケッコン	結婚
シャチョウ	社長
タイケン	体験
キメル	決める
キジュン	基準
ハツゲン	発言
トシ	都市
オヤ	親
キカイ	機会
テンカイ	展開
ジュギョウ	授業
ヒ	火
ジタイ	自体
キョウミ	興味
ケイサイ	掲載
ヘンシュウ	編集
センタク	選択
フクメル	含める
ハナシ	話し
シュウカン	週間
フタン	負担
モジ	文字
サイダイ	最大
ムリョウ	無料
ソウダン	相談
チュウイ	注意
オワル	終わる
カブ	株
ゼンブ	全部
カイシ	開始
ミ	身
オモシロイ	面白い
ブンセキ	分析
ドウジニ	同時に
ショウサイ	詳細
サキホド	先ほど
ハ	派
ヨミ	読み
ショウライ	将来
ヨサン	予算
アイ	愛
モクヒョウ	目標
ダイ	台
ツウシン	通信
ナガイ	長い
ブンヤ	分野
ハナ	花
コクナイ	国内
カエス	帰す
ツクル	作る
ツチ	土
ジコク	時刻
ギャク	逆
ハッケン	発見
サイコウ	最高
タメ	為
キキ	聞き
リエキ	利益
ショウ	小
ギンコウ	銀行
シュウリョウ	終了
ジム	事務
シュッパン	出版
レンラク	連絡
タイカイ	大会
レンシュウ	練習
サマザマ	様々
ムスメ	娘
シュウ	州
スクナイ	少ない
ドウヨウ	同様
チイサナ	小さな
オオサカ	大阪
キョウツウ	共通
フエル	増える
ゲンダイ	現代
ヒガイ	被害
ジュウタク	住宅
センキョ	選挙
アラタ	新た
カワル	変わる
ダイジ	大事
ヤマ	山
ヒハン	批判
ホウドウ	報道
シンパイ	心配
ホンジツ	本日
ザンネン	残念
ギョウカイ	業界
ソウトウ	相当
ギイン	議員
ギョウム	業務
ショウ	章
コウゲキ	攻撃
チカイ	近い
セイキ	世紀
エンソウ	演奏
カテイ	家庭
チョクセツ	直接
コウセイ	構成
ブンショウ	文章
アン	案
オキル	起きる
キボウ	希望
ツヨク	強く
キオク	記憶
カタガタ	方々
ヨバ	呼ば
トリヒキ	取引
ツクリ	作り
ツケル	付ける
オモエル	思える
シミン	市民
チョウ	超
アゲル	上げる
シキン	資金
トモダチ	友達
キケン	危険
ウンエイ	運営
ドウニュウ	導入
ヨソウ	予想
