アカリ	明かり
アガル	上がる
ウタウ	歌う
ウケル	受ける
デル	出る
シュッコク	出国
ユキ	行き
イキ	行き
ダイブン	大分
ダイブ	大分
イカス	生かす
イキイキ	生き生き
レンチュウ	連中
キジ	生地
オオカタ	大方
ホウ	方
シホウ	四方
ホンバ	本場
ジョウズ	上手
ニュウシュ	入手
ガクリョク	学力
ミル	見る
ヨゲン	予言
ゲンニ	現に
シュツゲン	出現
ゴウリ	合理
リガク	理学
ゼンシャ	前者
ケンチ	見地
メシタ	目下
イジ	意地
タイキン	大金
ドウサ	動作
セイテキ	性的
デイリ	出入り
ヨウスルニ	要するに
トマル	止まる
テイレ	手入れ
テホン	手本
ホンジツ	本日
ネンジュウ	年中
サイキョウ	最強
ナガイ	長い
ニュウリョク	入力
ダイショウ	大小
ゴウセイ	合成
コウム	公務
モチヌシ	持ち主
キマル	決まる
ミエル	見える
トリキメ	取り決め
イジョウ	以上
イチニンマエ	一人前
ヘル	経る
トオル	通る
ツレル	連れる
ハズス	外す
オモイヤリ	思いやり
サイジョウ	最上
ホウゲン	方言
ハナシアウ	話し合う
トシウエ	年上
ウケトル	受け取る
クブン	区分
ダイタイ	大体
ヨウリョウ	要領
タダイ	多大
メアテ	目当て
コウシン	行進
サイ	歳
シュトシテ	主として
ジヌシ	地主
ゼンポウ	前方
ダイ	題
アラタメル	改める
ダイタスウ	大多数
サダメル	定める
ヒョウキ	表記
マワス	回す
ハヤイ	早い
ニンゲンセイ	人間性
ジハツテキ	自発的
ソウタイテキ	相対的
カナメ	要
シンマイ	新米
キョウコウ	強行
ムスビ	結び
チカラヅヨイ	力強い
キリョク	気力
ヒトデ	人出
ヒノデ	日の出
サイショウ	最小
トイアワセル	問い合わせる
コウチ	高地
ナナツ	七つ
オシエ	教え
ハツメイ	発明
フリツ	府立
カッキ	活気
コウゲン	高原
トシツキ	年月
ネンゲツ	年月
ムリヤリ	無理やり
トク	得
カイヤク	解約
コクメイ	国名
フコウヘイ	不公平
セイチョウ	生長
ツレ	連れ
ガイケン	外見
フシギ	不思議
イッコウニ	一向に
コウサイ	交際
シュッセ	出世
ウケトリ	受け取り
ジメン	地面
タブン	多分
ブンカテキ	文化的
ミアイ	見合い
アテ	当て
ハンドウ	反動
シンカ	進化
ジュウリョク	重力
ブンギョウ	分業
ジュウタイ	重体
ヘタ	下手
メイキ	明記
クカク	区画
サンセイケン	参政権
フホンイ	不本意
ヤスウリ	安売り
クル	来る
フサク	不作
モクテキチ	目的地
ニュウキン	入金
ココチ	心地
ヤシン	野心
シンジャ	信者
ゼンシュウ	全集
デアウ	出会う
メイブツ	名物
ナリタツ	成り立つ
ソトガワ	外側
ナリユキ	成り行き
ガッキ	学期
サイゴ	最期
ヒキワケ	引き分け
コウゲン	公言
ヒキダシ	引き出し
メイショ	名所
イッケン	一見
ゲンシ	原子
スイチュウ	水中
スイブン	水分
センケツ	先決
ウゴカス	動かす
ジョウキョウ	上京
シュッピン	出品
ヒトメ	人目
ジツメイ	実名
ダイメイ	題名
チメイ	地名
カワス	交わす
ガイジン	外人
オモイダス	思い出す
イイマワシ	言い回し
トッケン	特権
セソウ	世相
セイリ	生理
ナイメン	内面
ショウタイ	正体
ネンシ	年始
ミナオス	見直す
タモツ	保つ
クダサル	下さる
クダル	下る
トシシタ	年下
ハンメイ	判明
キニュウ	記入
カイメン	海面
コウカ	高価
リョウカイ	領海
フゴウリ	不合理
カクシン	確信
コウリ	小売
マエウリ	前売り
サドウ	作動
リセイ	理性
ケン	権
オワル	終わる
カイシン	会心
ケッシン	決心
シンジュウ	心中
シンチュウ	心中
ナイシン	内心
ブンリツ	分立
サク	策
シタク	支度
ツヨイ	強い
シイル	強いる
イチドウ	一同
ケンブツ	見物
サンブツ	産物
ショモツ	書物
イキモノ	生き物
モノゴト	物事
セイネン	成年
コウシ	公使
アラソウ	争う
ハシュツジョ	派出所
タイダン	対談
ウツ	撃つ
ムゴン	無言
ムスウ	無数
サイド	再度
シナモノ	品物
ヒトメ	一目
セイカイ	正解
ブンカイ	分解
ヒトマエ	人前
ニンマエ	人前
ウミダス	生み出す
セイネンガッピ	生年月日
ジョウリュウ	上流
シガイ	市外
マシ	増し
ムコウ	向こう
コクユウ	国有
ハッスル	発する
マギワ	間際
トクサン	特産
ミンワ	民話
カッテ	勝手
ニンジョウ	人情
ヘイメン	平面
メンボク	面目
メンモク	面目
タイチョウ	体長
コクゼイ	国税
ゼイカン	税関
ブンガクシャ	文学者
ケントウ	見当
シュツダイ	出題
リョウガワ	両側
テクビ	手首
カゾエル	数える
イマニ	今に
アトマワシ	後回し
ジサン	持参
フツウ	不通
ヒニチ	日日
ウリダス	売り出す
コウエイ	公営
クム	組む
ウンコウ	運行
ココノツ	九つ
シリアウ	知り合う
アンガイ	案外
ミヤゲ	土産
ドダイ	土台
ドウジョウ	道場
カジツ	果実
ガッカイ	学界
オイタチ	生い立ち
タツ	立つ
ケツゴウ	結合
カケツ	可決
ブンベツ	分別
フンベツ	分別
サクモツ	作物
ブッタイ	物体
オウタイ	応対
デンポウ	電報
ヒキアゲル	引き上げる
ヒキサゲル	引き下げる
サイゲツ	歳月
ミウチ	身内
キメル	決める
チョウショ	長所
ヨウショ	要所
ツグ	次ぐ
シダイ	次第
フカ	付加
スイヘイ	水平
フノウ	不能
キル	切る
セツジツ	切実
ムメイ	無名
ムヨウ	無用
ハンツキ	半月
サイカイ	再会
シャセツ	社説
ネンピョウ	年表
ソウロン	総論
ショクモツ	食物
マッサキ	真っ先
カリュウ	下流
オオドオリ	大通り
ヨキ	予期
ナガシ	流し
ミズマシ	水増し
ホセイ	補正
ウタガウ	疑う
タイカ	大家
ヨカン	予感
コウジツ	口実
ユウセイ	優勢
アヤマチ	過ち
イキスギ	行き過ぎ
イチブブン	一部分
チュウダン	中断
ヘン	変
ムダン	無断
ヨコク	予告
ナンラ	何ら
ナンジュウ	何十
ガンライ	元来
カクジ	各自
キンセイ	近世
クイチガイ	食い違い
ケシゴム	消しゴム
ショウカ	消化
リョウリツ	両立
サダマル	定まる
ホウキ	法規
デキアガリ	出来上がり
エイリ	営利
ジエイ	自営
セイタイ	生態
ロジ	路地
アキ	空き
ウンドウカイ	運動会
チセイ	知性
モチイル	用いる
ネンパイ	年配
キョウヨウ	強要
ムジョウケン	無条件
タイベツ	大別
クヤクショ	区役所
ジツブツ	実物
フヒツヨウ	不必要
カマウ	構う
カエル	代える
アケガタ	明け方
ヒキズル	引きずる
インヨウ	引用
コウテイ	公定
ワリアテ	割り当て
ナガモチ	長持ち
ホイクショ	保育所
ウケミ	受け身
ミノマワリ	身の回り
ヘンシン	変身
キマリ	決まり
ゲスイ	下水
ムカンケイ	無関係
ムカンシン	無関心
ハンニチ	半日
シタギ	下着
センチャク	先着
テイチャク	定着
ハッチャク	発着
ヒッチャク	必着
ノセル	乗せる
シュショク	主食
セイケイ	生計
シンカ	真価
セイシ	生死
クワワル	加わる
デンリュウ	電流
ナンカン	難関
ハズレル	外れる
タイカク	体格
フゴウカク	不合格
キョウユウ	共有
チョクセン	直線
ヒナタ	日向
テギワ	手際
ドウカン	同感
ハンカン	反感
ヒトクチ	一口
ビョウジョウ	病状
ヤサシイ	優しい
ハナス	話す
スクナイ	少ない
ショウショウ	少々
スクナカラズ	少なからず
ホウダイ	放題
ブンタイ	文体
ゾクシュツ	続出
ジョウヨウ	常用
ヘイジョウ	平常
ゲンシ	原始
ハジメル	始める
シハツ	始発
ハジメ	始め
ケイダイ	境内
サガル	下がる
サイケツ	裁決
ジョゲン	助言
フシゼン	不自然
アキチ	空き地
ドウセイ	同性
ダイゼンテイ	大前提
リョウクウ	領空
カギリ	限り
ジゲン	時限
コユビ	小指
テキチュウ	的中
シタシム	親しむ
ショシン	初心
ホンシン	本心
カガイシャ	加害者
スイガイ	水害
クバル	配る
キクバリ	気配り
ゾウゲン	増減
シリョク	視力
ムシ	無視
ショウダン	商談
チイサイ	小さい
ベツメイ	別名
ヤクバ	役場
テツダイ	手伝い
ソウオウ	相応
ホウジル	報じる
ヒキトル	引き取る
ソダチ	育ち
ツカイミチ	使い道
カキカタ	書き方
シュウラク	集落
ラクゴ	落語
カハンシン	下半身
コウツウヒ	交通費
ラク	楽
キラク	気楽
コノマシイ	好ましい
コウカン	好感
スイリョク	水力
ホンノウ	本能
オコス	起こす
キョウヨウ	共用
タイイン	退院
テイキ	提起
ムジツ	無実
ホッキニン	発起人
ユライ	由来
ミズギ	水着
キル	着る
コクソ	告訴
ジンメイ	人名
ナダカイ	名高い
ジキ	時機
カイテン	開店
センシ	戦死
エイブン	英文
クワエル	加える
チュウリュウ	中流
ナンカイ	難解
ナンテン	難点
ブナン	無難
ソウテイ	想定
ウシロムキ	後ろ向き
イエデ	家出
コウロン	口論
アカイ	赤い
デイリグチ	出入り口
トウジル	投じる
マイアサ	毎朝
リョウシュウショ	領収書
フヘン	不変
シイレ	仕入れ
シアゲ	仕上げ
ナニゴト	何事
ブンポウ	文法
ナンデ	何で
タイキ	待機
ススム	進む
シンニュウ	進入
タダシイ	正しい
アシクビ	足首
チョクツウ	直通
ワタス	渡す
イジュウ	移住
ケサ	今朝
ジツレイ	実例
コウサテン	交差点
タツ	建つ
ハル	張る
ハンエイ	反映
ムゲン	無限
ムキゲン	無期限
セイキュウ	性急
キュウキョク	究極
ツウコウドメ	通行止め
ジツザイ	実在
ソウシン	送信
ツイキュウ	追求
ハンゲン	半減
ビジン	美人
ビヨウ	美容
ショウニン	商人
フカ	不可
ヘンヨウ	変容
ギリ	義理
ジュウヤク	重役
ヒトリ	独り
イニン	委任
トモバタラキ	共働き
チケイ	地形
エンケイ	円形
フケイキ	不景気
シツボウ	失望
ジョウハンシン	上半身
ノゾム	望む
ユウボウ	有望
オチツキ	落ち着き
ガクヒ	学費
ノハラ	野原
タノシイ	楽しい
タノシム	楽しむ
チノウ	知能
オコル	起こる
オモイキリ	思い切り
カクシン	核心
ココロエ	心得
マンイチ	万一
バンノウ	万能
ラッカンテキ	楽観的
カンシュウ	観衆
ジョウシャ	乗車
ロンリテキ	論理的
シャコウ	社交
ショクヒ	食費
バイテン	売店
マッサイチュウ	真っ最中
カク	格
カクベツ	格別
フエル	増える
ホンセン	本線
ユウノウ	有能
ムカウ	向かう
カンジュセイ	感受性
ジハク	自白
フカメル	深める
ハツビョウ	発病
ビョウニン	病人
ヒクイ	低い
ホウチ	放置
タツ	断つ
ナンビャク	何百
ハンスル	反する
ブキミ	不気味
マチナカ	町中
オウ	負う
チュウ	注
ウツス	移す
コウバン	交番
ミトメ	認め
ジサ	時差
ハンレイ	判例
ヒザシ	日差し
ハイタツ	配達
ハッタツ	発達
ゼンゼン	全然
ベッコ	別個
オンキョウ	音響
セイカク	正確
フウン	不運
オヤユビ	親指
シンセツ	親切
フビ	不備
シタシミ	親しみ
チカドウ	地下道
ドウリ	道理
チカミチ	近道
ガイ	害
テハイ	手配
チュウコ	中古
ズノウ	頭脳
ゴク	極
サンスウ	算数
テンカ	天下
ワカレル	別れる
グンコクシュギ	軍国主義
ドクダン	独断
ミタス	満たす
ユウイギ	有意義
マンテン	満点
エンズル	演ずる
ヘンケイ	変形
テビキ	手引き
ネアガリ	値上がり
ヒキダス	引き出す
タリョウ	多量
ショウリョウ	少量
タイボウ	待望
ソウギ	争議
カンセツ	間接
タイガク	退学
ウツワ	器
ショッキ	食器
ガイカン	外観
ダイギシ	代議士
チャクシュ	着手
ウワギ	上着
ニッコウ	日光
ワショク	和食
イチダンラク	一段落
カイロ	回路
タイヒ	対比
ダンドリ	段取り
ノコル	残る
ムザン	無残
ヒトリ	一人
ノコラズ	残らず
カイソウ	回想
ナイカ	内科
デンセン	電線
ユウキブツ	有機物
ウタガワシイ	疑わしい
ノウリツ	能率
オウトウ	応答
モヨオシ	催し
ヨナカ	夜中
ヨアケ	夜明け
ジコウ	時効
ハナツ	放つ
ミハナス	見放す
チシツ	地質
ハカル	図る
ナンダカ	何だか
シュウカン	週間
オトコマエ	男前
マツ	待つ
タメス	試す
イチヨウ	一様
ロクガ	録画
シントウ	神道
テイサイ	体裁
センレイ	先例
デンタツ	伝達
コウゼン	公然
ヒツゼンテキ	必然的
リョウシン	良心
デンキュウ	電球
カイキ	回帰
ホドウ	歩道
ケツマツ	結末
ゲツマツ	月末
シマツ	始末
シュウテン	終点
キャッカン	客観
ドテ	土手
イソグ	急ぐ
カンゲキ	感激
キョクゲン	極限
ミキワメル	見極める
テンタイ	天体
ビジョ	美女
コウテイ	工程
アワセル	合わせる
デンゴン	伝言
オテツダイ	お手伝い
ケイシキテキ	形式的
ネビキ	値引き
キキトリ	聞き取り
ワカ	和歌
ラッカ	落下
オトス	落とす
ジッピ	実費
ヒコウ	非行
メンダン	面談
オウセツ	応接
コノム	好む
コウテン	好転
ホドコス	施す
チョクゲキ	直撃
カリョク	火力
ムロン	無論
バンニン	万人
バンジン	万人
バンザイ	万歳
ガクイ	学位
ショウヒン	賞品
セッキョウ	説教
ハヤサ	速さ
ブシ	武士
モノオキ	物置
ノリモノ	乗り物
ハナミ	花見
カイショク	会食
ウミベ	海辺
テイショク	定食
ニッショク	日食
ツウロ	通路
バイシュン	売春
トビダス	飛び出す
ナゴリ	名残
アッコウ	悪口
ワルクチ	悪口
ボウスイ	防水
ボウセン	防戦
シロイ	白い
マッシロ	真っ白
ネントウ	年頭
クチサキ	口先
フカマル	深まる
ゴウ	号
カイトウ	解答
サイク	細工
オサマル	収まる
オサメル	収める
コウリョク	効力
ダンジテ	断じて
ダンスイ	断水
ダンテイ	断定
アオゾラ	青空
ナンゼン	何千
マチウケル	待ち受ける
ホソク	補足
カトキ	過渡期
シッカク	失格
トウバン	当番
ムセキニン	無責任
サシヒキ	差し引き
ナラビ	並び
ナミ	並み
コウシュウ	公衆
タッスル	達する
ビョウシツ	病室
ダンゼン	断然
ヒツゼン	必然
カンモン	関門
ウツル	写る
ヒッパル	引っ張る
キドウタイ	機動隊
ムセイゲン	無制限
ソナワル	備わる
キャクシツ	客室
ワフウ	和風
フルイ	古い
カクチョウ	拡張
ハッソウ	発送
ヒケツ	否決
シュジュ	種々
イッシュウ	一周
シンドウ	振動
オモカゲ	面影
エンマン	円満
ヤクニタツ	役に立つ
オクガイ	屋外
カオク	家屋
トウキ	登記
ヨム	読む
ソダツ	育つ
シツリョウ	質量
ウタゴエ	歌声
ネマワシ	根回し
ミヂカ	身近
ハンシン	半身
カイテ	買い手
ニガイ	苦い
セツゾク	接続
ショウカ	消火
ジュワキ	受話器
カンネン	観念
シハン	市販
ノル	乗る
ゴゾンジ	ご存じ
デンエン	田園
キグ	器具
ヨウグ	用具
エイワ	英和
ヒコウジョウ	飛行場
イドウ	異動
トクイ	特異
ユウズウ	融通
ジタイ	辞退
シャドウ	車道
ニュウジョウケン	入場券
フカミ	深み
マッカ	真っ赤
キゴウ	記号
タンゴ	単語
タンコウボン	単行本
トウアン	答案
コンヤ	今夜
ホソイ	細い
ブンケン	文献
ヨゾラ	夜空
ゲンカク	厳格
フダン	不断
メイセイ	名声
アイズ	合図
トクシツ	特質
アイスル	愛する
ナニシロ	何しろ
ジッキョウ	実況
ヤブル	破る
ツム	積む
マチカマエル	待ち構える
ハツオン	発音
モウシアゲル	申し上げる
チョウミリョウ	調味料
トリケス	取り消す
イコウ	以降
カコウ	下降
ギフ	義父
シキベツ	識別
ムイシキ	無意識
イデン	遺伝
チョウカ	超過
ソソグ	注ぐ
ロウリョク	労力
ナミキ	並木
ジュウジ	従事
ハヤクチ	早口
ヒガエリ	日帰り
ヘイタイ	兵隊
ユウゲン	有限
ミマイ	見舞い
アヤウイ	危うい
アヤウク	危うく
サンリン	山林
リンギョウ	林業
サイテン	採点
スイリ	推理
アゲル	上げる
スイソ	水素
ホッキョク	北極
オイダス	追い出す
シュウキ	周期
コウミンカン	公民館
スイゾクカン	水族館
タイガ	大河
カワラ	河原
フリ	振り
ブリ	振り
ゲッキュウ	月給
コウロ	航路
ノボル	登る
トンヤ	問屋
トウヨウ	登用
ヒヤヤカ	冷ややか
ネサガリ	値下がり
モケイ	模型
ハツイク	発育
テキオウ	適応
ノゾマシイ	望ましい
オチバ	落ち葉
ケシキ	景色
シンユウ	親友
ヘイエキ	兵役
ムカエ	迎え
クミコム	組み込む
バンジ	万事
オチコム	落ち込む
カンショウ	観賞
スガオ	素顔
コウセン	光線
ノリキ	乗り気
ヨケイ	余計
ヒダリガワ	左側
クウソウ	空想
シャカイカガク	社会科学
コクハク	告白
オモシロイ	面白い
コウテイ	高低
モヨオス	催す
タンチョウ	単調
カンサン	換算
ツヤ	通夜
ヒキカエ	引き換え
ザダンカイ	座談会
ハッセイ	発声
イトシイ	愛しい
ダハ	打破
ヨウセキ	容積
ミツモリ	見積もり
タメシ	試し
ボウラク	暴落
ジョガイ	除外
シンプ	神父
セビロ	背広
モクロク	目録
キセイ	帰省
ナラビニ	並びに
ジムシツ	事務室
ミチ	未知
ミギガワ	右側
シュウギョウ	修業
サイゲン	際限
キマツ	期末
ジッシュウ	実習
シタシイ	親しい
シンニチ	親日
サイシュ	採取
タノミ	頼み
マナツ	真夏
フルホン	古本
ギンガ	銀河
コヅカイ	小遣い
ヒトカゲ	人影
ジキュウ	時給
ショニンキュウ	初任給
メイジル	命じる
メイチュウ	命中
オクナイ	屋内
チュウト	中途
ブンリョウ	分量
ベンロン	弁論
ギボ	義母
サンフジンカ	産婦人科
ネイロ	音色
クロイ	黒い
ボウカ	防火
ヒバナ	火花
ブンルイ	分類
アウ	会う
ムゾウサ	無造作
イセイ	異性
カンキン	監禁
シゼンカガク	自然科学
ルス	留守
アゲル	挙げる
テイケイ	定型
ケン	券
テイデン	停電
セキドウ	赤道
フリカエル	振り返る
ナイリク	内陸
マヨナカ	真夜中
サクヤ	昨夜
ユウベ	昨夜
チョウダイ	長大
デンゲン	電源
シオクリ	仕送り
アイチャク	愛着
アシオト	足音
ボウオン	防音
モウス	申す
マルイ	丸い
ユビワ	指輪
テッキン	鉄筋
センコク	宣告
ユイゴン	遺言
ショジョ	処女
ツキヒ	月日
マチナミ	町並み
アツイ	熱い
ミゼン	未然
ワシツ	和室
ミセイネン	未成年
シュクダイ	宿題
シュクメイ	宿命
ウツス	写す
キカ	帰化
ナガイキ	長生き
マウ	舞う
ランヨウ	乱用
ツラネル	連ねる
マツジツ	末日
ライキャク	来客
オリモノ	織物
カザムキ	風向き
ブンサン	分散
ショカ	初夏
ゴクラク	極楽
ソシツ	素質
アンピ	安否
コイ	故意
ウンガ	運河
フウセン	風船
ヨウガ	洋画
リョウジカン	領事館
ゼンイ	善意
マンメン	満面
ホンヤ	本屋
コンヤク	婚約
テイキアツ	低気圧
エンゲイ	園芸
キョヨウ	許容
コンジョウ	根性
マチノゾム	待ち望む
キンイロ	金色
コンジキ	金色
フロク	付録
セイテツ	製鉄
キンパク	緊迫
クルシイ	苦しい
クルシメル	苦しめる
フミキリ	踏切
ユウエキ	有益
ショウチ	承知
カオイロ	顔色
センニュウカン	先入観
ハヤイ	速い
ヒニヒニ	日に日に
ジュンバン	順番
ショウニカ	小児科
タヨリ	便り
ヒトダカリ	人だかり
アマル	余る
ホリュウ	保留
カキトメ	書留
テイキケン	定期券
オウサマ	王様
フカイ	深い
ジュヨ	授与
ヘンジョウ	返上
コウフク	幸福
ヒョウシキ	標識
コンダテ	献立
ネンチョウ	年長
ヤケイ	夜景
マナブ	学ぶ
キビシイ	厳しい
キキメ	効き目
キゲン	起源
ハキョク	破局
サイシ	妻子
ヘンニュウ	編入
ジメイ	自明
シュウリョウ	修了
ナカツギ	中継ぎ
トチョウ	都庁
アリサマ	有り様
ネラウ	狙う
イットウ	１等
ヨビダス	呼び出す
ヨビナ	呼び名
シュウネン	執念
カヤク	火薬
ハンガ	版画
ヤッキョク	薬局
ツクル	作る
ショホ	初歩
ソウシキ	葬式
ホウレイ	法令
ヒトドオリ	人通り
ソナエル	備える
フウリョク	風力
レイボウ	冷房
イイナリ	言いなり
ツノル	募る
オボエ	覚え
コウキョウキョク	交響曲
ミカク	味覚
ハゲシイ	激しい
ヒニン	否認
コウテイ	行程
セイシ	静止
バイゾウ	倍増
ザイモク	材木
セイミツ	精密
テイエン	庭園
ヒアタリ	日当たり
カケイ	家系
シンコン	新婚
トジョウ	途上
ミコン	未婚
ベンメイ	弁明
カアサン	母さん
シタミ	下見
サガリ	下がり
ジシュ	自首
ハクガイ	迫害
ブトウ	舞踏
デムカエ	出迎え
ゼイムショ	税務署
フイ	不意
デンチ	電池
ワガヤ	我が家
アクニン	悪人
シュッキン	出勤
テンキン	転勤
キンジル	禁じる
ルスバン	留守番
ジツヨウテキ	実用的
オオザッパ	大ざっぱ
オオマカ	大まか
ヨウジ	用事
シュウガクリョコウ	修学旅行
リョカクキ	旅客機
リョケン	旅券
リョヒ	旅費
ハイゼツ	廃絶
ヨクシ	抑止
ナオル	治る
テワケ	手分け
ヘンシン	返信
イマ	居間
ドウキョ	同居
リリク	離陸
カンキ	換気
キョウチョウ	強調
コウオン	高温
コンザツ	混雑
アットウ	圧倒
マルミ	丸み
アカリ	明り
シャリン	車輪
ウラナイ	占い
フカンゼン	不完全
フショウ	負傷
ロクオンテープ	録音テープ
エイキュウ	永久
スクイ	救い
キュウシキ	旧式
ショクブツエン	植物園
タウエ	田植え
ヘイコウ	並行
ナゴヤカ	和やか
ウエキ	植木
ワカル	分かる
チョウシュウ	徴収
イガイ	以外
ゲシュク	下宿
シャコ	車庫
ハン	版
マエモッテ	前もって
シュウシ	修士
ハンソク	反則
ホウソク	法則
オウダンホドウ	横断歩道
サンカク	三角
キシベ	岸辺
ムフウ	無風
ケッテン	欠点
ソクリョウ	測量
ゴクヒ	極秘
ホウサク	豊作
ゲンミツ	厳密
ミツド	密度
タテツヅケ	立て続け
コウキアツ	高気圧
ヨロコブ	喜ぶ
オオヨロコビ	大喜び
ベンカイ	弁解
ヨロコバス	喜ばす
コンキ	根気
ダイコン	大根
テキド	適度
カイチク	改築
アラタメテ	改めて
スバラシイ	素晴らしい
アッパク	圧迫
イシ	意志
クシン	苦心
アシブミ	足踏み
ヨウフク	洋服
エキイン	駅員
ハッカ	発火
シワス	師走
ヨビカケル	呼び掛ける
ハイフ	配布
チュウセイ	中性
ツトメ	勤め
タサツ	他殺
ヨウヤク	要約
インシ	印紙
ショウソク	消息
テイシャ	停車
ヨウコウ	要項
ヨクアツ	抑圧
サイワイ	幸い
ヒョウホン	標本
ベッキョ	別居
オンシツ	温室
ガイキ	外気
キショウ	気性
キタイ	気体
タイオン	体温
テイオン	低温
アイドク	愛読
アイヨウ	愛用
ドウ	同
ヨウテン	要点
アイソウ	愛想
アイソ	愛想
カンリョウ	完了
ムキュウ	無休
カキ	夏季
ガンボウ	願望
ハマベ	浜辺
コエル	越える
シメキル	締め切る
ヒッコシ	引っ越し
ハネ	羽根
コウトウガッコウ	高等学校
フツゴウ	不都合
フビョウドウ	不平等
スクウ	救う
チョウヘイ	徴兵
ウル	得る
カクトウ	格闘
ヨク	欲
ウリアゲ	売り上げ
クツウ	苦痛
ズツウ	頭痛
ヒッシュウ	必修
ロウカ	老化
カンショク	感触
ウマレツキ	生まれつき
ドウラン	動乱
ニッカン	日刊
ミダレル	乱れる
ランボウ	乱暴
フカヒ	不可避
サイシュウ	採集
ヨソオウ	装う
ソンエキ	損益
ソコナウ	損なう
サカサ	逆さ
タヨル	頼る
アッシュク	圧縮
タチバナシ	立ち話
ホケツ	補欠
モル	盛る
セイダイ	盛大
ゾクスル	属する
ウラギル	裏切る
カワギシ	河岸
サクジョ	削除
ドウカ	同化
キンイツ	均一
シンミツ	親密
ブンツウ	文通
ミツバイ	密売
ミアワセル	見合わせる
コウリョ	考慮
キザム	刻む
ユウソウ	郵送
オモイ	重い
ヨミカキ	読み書き
ニンソウ	人相
ラクサツ	落札
フム	踏む
フリエキ	不利益
ムカエル	迎える
トリコム	取り込む
ウチコム	打ち込む
ビョウシャ	描写
コワス	壊す
ギョウレツ	行列
ブンプ	分布
スズ	鈴
タンケン	探検
アンノジョウ	案の定
チョウカク	聴覚
ケンケツ	献血
アガル	挙がる
ヨウジン	用心
ギャクコウカ	逆効果
ハンギャク	反逆
シセツ	使節
セツヤク	節約
ソウシツ	喪失
コウウン	幸運
オトシダマ	お年玉
キュウヨウ	休養
ヨウシ	養子
ケイシ	軽視
オナジ	同じ
モクヨウ	木曜
ユダン	油断
マチカド	街角
カイドウ	街道
ジホウ	時報
ヒキツグ	引き継ぐ
スマス	済ます
シンド	震度
カセイ	火星
シュツガン	出願
ツキミ	月見
センダッテ	先だって
ドウトウ	同等
ヒガン	彼岸
ユウトウセイ	優等生
ケイジ	掲示
チュウワ	中和
ミワケ	見分け
コタイ	固体
オオアメ	大雨
ヒンメイ	品名
ヒゴロ	日ごろ
ヘイカイ	閉会
タタカウ	闘う
ヒビ	日々
ヒトツ	一つ
ショクヨク	食欲
ヨッキュウ	欲求
ヨクボウ	欲望
ロンジル	論じる
ツイセキ	追跡
フキソク	不規則
フヘイ	不平
クニ	国
クニグニ	国々
コッカイ	国会
ショウジル	生じる
ダイショウ	代償
ホウイ	包囲
ホウソウ	包装
チュウシャ	駐車
ヒトビト	人々
トシ	年
ネンネン	年々
シュウトク	習得
フヤス	増やす
オオイニ	大いに
タイカイ	大会
タイコク	大国
オトナ	大人
オオキイ	大きい
オオゲサ	大げさ
ジャクテン	弱点
コウスイ	香水
ジツワ	実話
フタツ	二つ
フタリ	二人
タイスル	対する
サイセンタン	最先端
カツ	勝つ
ホンゴク	本国
ホンニン	本人
ホンネン	本年
マッタン	末端
アラワレ	現れ
スイソク	推測
チュウネン	中年
ニッチュウ	日中
マイスウ	枚数
カイチョウ	会長
コッセツ	骨折
ナガサ	長さ
ナガネン	長年
ダス	出す
バケル	化ける
コトバヅカイ	言葉遣い
コウゴ	交互
ミッツ	三つ
ショケイ	処刑
サン	三
ドウイツ	同一
ミッシュウ	密集
コウテイ	校庭
トキ	時
ナカニワ	中庭
ドウジ	同時
ニチジ	日時
イチジ	一時
トキドキ	時々
ヒエル	冷える
ヒヤス	冷やす
ハナタバ	花束
コト	事
ジンジ	人事
ダイジ	大事
テツヤ	徹夜
ミズカラ	自ら
ジコク	自国
ナカヨク	仲良く
ユウダイ	雄大
エイコウ	栄光
キゾク	貴族
ギョウ	行
ギョウジ	行事
ギョウセイ	行政
テキセイ	適性
オコナウ	行う
カイシャ	会社
カイサツ	改札
シャカイ	社会
シャカイジン	社会人
シャチョウ	社長
チョッカン	直感
ホンシャ	本社
カイケン	会見
ミゴト	見事
ミダシ	見出し
ミホン	見本
ネンガッピ	年月日
タチヨル	立ち寄る
ルイジ	類似
ヨビカケ	呼びかけ
エキベン	駅弁
ジブン	自分
ジュウブン	十分
ワケル	分ける
ワカレル	分かれる
カイギ	会議
ギカイ	議会
ギチョウ	議長
クイコム	食い込む
ウシロ	後ろ
ウカベル	浮かべる
コワレル	壊れる
デマエ	出前
ゼンゴ	前後
ゼンネン	前年
ウリテ	売り手
オソラク	恐らく
ウツ	討つ
コクミン	国民
ジンミン	人民
クレル	暮れる
オソレル	恐れる
コウクウビン	航空便
ジンセイ	人生
イキル	生きる
セイゼン	生前
フベン	不便
イッショウ	一生
シュッショウ	出生
シュッセイ	出生
ウンドウジョウ	運動場
ウンドウバ	運動場
コクレン	国連
レンジツ	連日
ヒトリヒトリ	一人一人
キンモツ	禁物
イツツ	五つ
ゴブ	五分
キゴコロ	気心
カリル	借りる
シュッパツ	出発
ココロアタリ	心当たり
ツウヨウ	通用
ハツ	発
ハッケン	発見
ハッコウ	発行
ハッセイ	発生
アイダ	間
ジカン	時間
ニンゲン	人間
オソイ	遅い
チュウカン	中間
ネンカン	年間
ミンカン	民間
カンセツ	関節
タイニチ	対日
アガリ	上がり
ノボリ	上り
イチブ	一部
ダイブブン	大部分
ニクタイ	肉体
ブチョウ	部長
ブブン	部分
ホンブ	本部
ロコツ	露骨
ヒガシ	東
トウブ	東部
ノウニュウ	納入
ノリカエル	乗り換える
コウシャ	後者
キマグレ	気まぐれ
セイトウ	政党
タンキダイガク	短期大学
トウ	党
カイサンブツ	海産物
ケイソツ	軽率
ダイチ	大地
ツチ	地
チジョウ	地上
モチモノ	持ち物
カイゴウ	会合
マニアウ	間に合う
アウ	合う
アイマ	合間
ゴウドウ	合同
レンゴウ	連合
オウズル	応ずる
マニアワセル	間に合わせる
キリツ	規律
シチョウ	市長
シミン	市民
アバレル	暴れる
アクム	悪夢
ギョウシャ	業者
ジギョウ	事業
ミノル	実る
ヒキツギ	引き継ぎ
コクナイ	国内
シナイ	市内
ウチ	内
ナイブ	内部
エノグ	絵の具
ゲンジュウショ	現住所
ソウカン	相関
イッポウ	一方
ミカタ	見方
コウホウ	後方
ユクエ	行方
チホウ	地方
カタガタ	方々
ミセビラカス	見せびらかす
ミセル	見せる
ヨッツ	四つ
ヨン	四
イッテイ	一定
ミカヅキ	三日月
テイネン	定年
ドウジル	動じる
イマ	今
コンゲツ	今月
コンゴ	今後
ムチ	無知
ムホウ	無法
コンニチ	今日
コトシ	今年
イママデ	今まで
カイ	回
コンカイ	今回
サライネン	再来年
テジナ	手品
ゼンカイ	前回
アタラシイ	新しい
アラタ	新た
シンジン	新人
シンネン	新年
ホウイ	方位
メウエ	目上
カイジョウ	会場
アラワス	表す
イチバ	市場
シュツジョウ	出場
バアイ	場合
セイツウ	精通
ソウバ	相場
ロンズル	論ずる
ジョウチョ	情緒
ジョウショ	情緒
オカネ	お金
アクシュ	握手
イタイ	痛い
イチイン	一員
カイイン	会員
ギイン	議員
シャイン	社員
ナマヌルイ	生ぬるい
テイイン	定員
フレアイ	触れ合い
サンリュウ	三流
キュウ	九
ニホンシュ	日本酒
ニュウコク	入国
ニュウシャ	入社
ニュウジョウ	入場
ブツゾウ	仏像
センシュツ	選出
センテイ	選定
ニュウセン	入選
ユウスル	有する
エラブ	選ぶ
コクリツ	国立
シリツ	市立
タイリツ	対立
チュウリツ	中立
タチバ	立場
カンズル	感ずる
カイカイ	開会
カイハツ	開発
トクバイ	特売
ムクチ	無口
キョクセン	曲線
ミアゲル	見上げる
テマ	手間
テマエ	手前
センシュ	選手
アイテ	相手
オオテ	大手
トオリスギル	通り過ぎる
ドウドウ	堂々
ニチベイ	日米
グン	群
ムレ	群れ
シュツリョク	出力
バツグン	抜群
ヒョウリ	表裏
ウラガエシ	裏返し
コクリョク	国力
ガッカイ	学会
ガクシャ	学者
ガクセイ	学生
ガクチョウ	学長
ガクネン	学年
ガクブ	学部
ケンガク	見学
コドモ	子供
ダイガク	大学
チュウガク	中学
チュウガクセイ	中学生
ニュウガク	入学
ガクモン	学問
ウチアゲル	打ち上げる
トイ	問い
トウ	問う
タカイ	高い
タカサ	高さ
タカマル	高まる
タカメル	高める
ジダイ	時代
ダイキン	代金
ダイコウ	代行
ネンダイ	年代
カワリ	代わり
ソウゲン	草原
アキラカ	明らか
アカルイ	明るい
ミョウニチ	明日
アシタ	明日
アス	明日
オクユキ	奥行き
ジジツ	事実
ジツハ	実は
ジッコウ	実行
ジツリョク	実力
マコトニ	実に
ジツニ	実に
デンアツ	電圧
イチエン	一円
エン	円
エンダカ	円高
ハジマル	始まる
チュウサイ	仲裁
ヤク	約
カンレン	関連
カコイ	囲い
ギケツ	議決
ケッシテ	決して
ケツギ	決議
ケッテイ	決定
タイケツ	対決
ブンシ	分子
コウドウ	行動
ジドウ	自動
フンバル	踏ん張る
ウゴキ	動き
ドウイン	動員
ドウリョク	動力
ワフク	和服
カクスル	画する
シンニュウ	侵入
ゼンイン	全員
ゼンブ	全部
ゼンリョク	全力
ゼンコク	全国
ガイライゴ	外来語
モクゼン	目前
ダイヒョウ	代表
ハッピョウ	発表
イキキ	行き来
テガカリ	手掛かり
ツクリアゲル	作り上げる
センジョウ	戦場
センゼン	戦前
タイセン	大戦
タタカイ	戦い
センゴ	戦後
オキ	沖
フジュン	不順
ビンジョウ	便乗
カヨウ	通う
ドオリ	通り
ツウガク	通学
ツウコウ	通行
ミトオシ	見通し
ホカ	外
ハズレ	外れ
ガイコク	外国
ガイコクジン	外国人
ガイシュツ	外出
ガイショウ	外相
ガイブ	外部
コクガイ	国外
チョウコウ	聴講
ニゲル	逃げる
トウソウ	逃走
コンケツ	混血
モットモ	最も
サイゴ	最後
サイコウ	最高
サイダイ	最大
ネンショウ	燃焼
イイカタ	言い方
イワバ	言わば
ゲンドウ	言動
ハツゲン	発言
ヒトコト	一言
キュウヘン	急変
ダンゼツ	断絶
チョウセツ	調節
ゲンキン	現金
ゲンジツ	現実
ゲンバ	現場
ゲンダイ	現代
ゲンチ	現地
ジツゲン	実現
ヒョウゲン	表現
スイバク	水爆
ケイリ	経理
ゲンテン	減点
ダイリ	代理
チリ	地理
リジ	理事
オル	居る
シラベ	調べ
チョウシ	調子
チョウリ	調理
イッタイ	一体
ゴゲン	語源
ジンタイ	人体
ゼンタイ	全体
カラダ	体
タイチョウ	体調
タイリョク	体力
ホンタイ	本体
リッタイ	立体
カガク	化学
ゴウリカ	合理化
マックラ	真っ暗
ハチョウ	波長
メイアン	明暗
ナル	成る
ソウトウ	相当
タオス	倒す
アタリ	当たり
アタリマエ	当たり前
アテル	当てる
トウジシャ	当事者
トウジ	当時
トウニン	当人
トウセン	当選
トウジツ	当日
トウブン	当分
ホントウ	本当
ユウエンチ	遊園地
テアテ	手当
キゴ	季語
ムクイル	報いる
ハチ	八
ワル	割る
ツグ	継ぐ
コンワク	困惑
ロク	六
ウタ	歌
シヨウニン	使用人
セイガン	請願
キコエル	聞こえる
ジシュ	自主
オモニ	主に
シュタイ	主体
チュウショウ	中傷
ミンシュ	民主
アブラエ	油絵
シュジン	主人
ギダイ	議題
シュダイ	主題
モンダイ	問題
ヒッコス	引っ越す
サゲル	下げる
クダリ	下り
キドル	気取る
ハラッパ	原っぱ
ショクン	諸君
ジョウゲ	上下
ノリコエル	乗り越える
チカ	地下
シメル	締める
ブカ	部下
ミツケル	見つける
シュショウ	首相
モエル	燃える
ネンピ	燃費
クビ	首
イガイ	意外
イケン	意見
ケツイ	決意
ゴウイ	合意
ダイナシ	台無し
ドウイ	同意
シナギレ	品切れ
ホジュウ	補充
ムジ	無地
ヤワラグ	和らぐ
ヤワラゲル	和らげる
ケンジツ	堅実
コケイ	固形
ゴウホウ	合法
ホウホウ	方法
ホウガク	法学
ホウジン	法人
ミンポウ	民法
リッポウ	立法
シュウチャク	執着
フジュウブン	不十分
フトウ	不当
フホウ	不法
フメイ	不明
オクリモノ	贈り物
デキゴト	出来事
ホンライ	本来
ホシイ	欲しい
ライ	来
ライゲツ	来月
ライニチ	来日
ライネン	来年
オキモノ	置物
マジワル	交わる
ツナ	綱
サク	作
サギョウ	作業
サクシャ	作者
サクセン	作戦
タベル	食べる
ショクパン	食パン
ホッサ	発作
ヘイホウ	平方
シホンカ	資本家
カイリュウ	海流
ゴウリテキ	合理的
ジシュテキ	自主的
シンカン	新刊
ホウテキ	法的
モクテキ	目的
シュヨウ	主要
フセグ	防ぐ
ヨウスル	要する
フヨウ	不要
サヨウ	作用
ジツヨウ	実用
ダイヨウ	代用
ヨウイ	用意
セイサク	制作
セイテイ	制定
セイヤク	制約
タイセイ	体制
ハッシャ	発車
ブンボウグ	文房具
キキャク	棄却
ジチ	自治
セイジ	政治
クチカズ	口数
メイジ	明治
コウド	高度
コンド	今度
ノボル	上る
セイド	制度
タンテキ	端的
ネンド	年度
ハンパ	半端
ガイム	外務
ツトメル	務める
ジム	事務
ジムイン	事務員
ホウム	法務
メンスル	面する
ハカル	測る
ツヨサ	強さ
ツヨメル	強める
キョウカ	強化
キョウセイ	強制
キョウリョク	強力
グンシュウ	群衆
キブン	気分
ツヨキ	強気
ニンキ	人気
セツダン	切断
タイキ	大気
ハラウ	払う
ホンキ	本気
ヨウショク	洋食
ショウガクセイ	小学生
ドウセイ	動静
シチ	七
ジュウフク	重複
チョウフク	重複
ミツニュウコク	密入国
アワス	合わす
セイジン	成人
セイチョウ	成長
セイブン	成分
セイリツ	成立
アタル	当たる
キカン	期間
キジツ	期日
コウキ	後期
ジキ	時期
ゼンキ	前期
チョウキ	長期
テイキ	定期
ドウキ	同期
ヤツアタリ	八つ当たり
コウカイ	公開
コウヒョウ	公表
コウムイン	公務員
コウメイ	公明
コウヤク	公約
コウリツ	公立
タバ	束
タル	足る
テッスル	徹する
カネモチ	金持ち
ミチガエル	見違える
モツ	持つ
シンサツ	診察
オオサワギ	大騒ぎ
キモチ	気持ち
モチ	持ち
ブンヤ	分野
ヤガイ	野外
ヤトウ	野党
キョウギ	協議
キョウリョク	協力
ザイバツ	財閥
トル	取る
トッテ	取っ手
トリシラベ	取り調べ
ミドコロ	見どころ
シュト	首都
ミヤコ	都
トカイ	都会
ツゴウ	都合
トシ	都市
トナイ	都内
トリツ	都立
セイタン	生誕
チョウワ	調和
トウイツ	統一
トウゴウ	統合
トウチ	統治
トウセイ	統制
イカ	以下
イゴ	以後
イゼン	以前
イナイ	以内
イライ	以来
コウゴ	口語
ハヘン	破片
ウワキ	浮気
カタテ	片手
キカイ	機会
キカン	機関
キタイ	機体
キチョウ	機長
ドウキ	動機
マドワス	惑わす
ケイイ	敬意
コウヘイ	公平
ヘイジツ	平日
ヘイネン	平年
ヘイヤ	平野
ヘイワ	平和
ワヘイ	和平
ヘイセイ	平成
カラッポ	空っぽ
フタゴ	双子
ソウカイ	総会
ソウリ	総理
ドウヨウ	動揺
ソウゴウ	総合
カニュウ	加入
ツトメサキ	勤め先
コウコウ	孝行
ナカユビ	中指
ヤマ	山
オモワズ	思わず
カリ	借り
ダッスイ	脱水
ダツラク	脱落
トウタツ	到達
オモイ	思い
オモイデ	思い出
オモウ	思う
ダッソウ	脱走
カジ	家事
ヤヌシ	家主
カナイ	家内
ハタス	果たす
コッカ	国家
サッカ	作家
ジッカ	実家
セイジカ	政治家
アタエル	与える
タビダツ	旅立つ
イッカ	一家
カイワ	会話
シンシツ	寝室
タイワ	対話
ツウワ	通話
ワダイ	話題
ハナシ	話
ハナシアイ	話し合い
ショキュウ	初級
ヨノナカ	世の中
セケン	世間
セダイ	世代
セワ	世話
チュウセイ	中世
ドアイ	度合
ウケイレル	受け入れる
ソウベツ	送別
クカン	区間
ハンシャ	反射
ヨウケン	用件
キマエ	気前
ダイトウリョウ	大統領
ミレン	未練
アタタカイ	温かい
カクス	隠す
カヨウ	火曜
カヨウビ	火曜日
ケンリツ	県立
ドクガク	独学
ジゾク	持続
ソウゾク	相続
ナイゾウ	内臓
レンゾク	連続
ゾクゾク	続々
テツヅキ	手続き
ツヅキ	続き
エンジル	演じる
シンガク	進学
シンコウ	進行
シンシュツ	進出
ゼンシン	前進
コウセイ	公正
シュウデン	終電
セイ	正
ショウガツ	正月
セイトウ	正当
タイショウ	大正
フセイ	不正
ナガビク	長引く
アンゼン	安全
アンテイ	安定
エンヤス	円安
ガンショ	願書
ケンブン	見聞
チアン	治安
フアン	不安
フアンテイ	不安定
メヤス	目安
カイセツ	開設
カンスル	関する
コウバイ	購買
スギ	杉
セッテイ	設定
セツリツ	設立
シヒ	私費
ハッキ	発揮
ホアン	保安
トコロドコロ	所々
カイセイ	改正
ゲンショ	原書
トリダス	取り出す
ナヅケル	名付ける
トリキメ	取決め
カイスウ	回数
スウガク	数学
ソウスウ	総数
タスウ	多数
ニンズウ	人数
カズ	数
ニッスウ	日数
ヒキオコス	引き起こす
シルス	記す
キジ	記事
キシャ	記者
ニッキ	日記
ダイガクイン	大学院
ニュウイン	入院
ウキ	雨期
オンナ	女
オンナノコ	女の子
ジョシ	女子
ジョセイ	女性
チョウジョ	長女
トウナン	盗難
ニッシ	日誌
メダツ	目立つ
サイショ	最初
シバフ	芝生
ハツ	初
ショキ	初期
ショニチ	初日
ダケツ	妥結
コロガス	転がす
コロガル	転がる
トウショ	当初
キタ	北
ホクブ	北部
ホクトウ	北東
クイサガル	食い下がる
ゴゴ	午後
ゴゼン	午前
ショウゴ	正午
タイショウ	対照
ユビ	指
シテイ	指定
テンケイテキ	典型的
オモテドオリ	表通り
イザカヤ	居酒屋
ケンリョク	権力
シカ	歯科
シュケン	主権
ジンケン	人権
セイケン	政権
ネンガジョウ	年賀状
アツカウ	扱う
アンシン	安心
カンシン	関心
シンリ	心理
チヘイセン	地平線
チュウシン	中心
トシン	都心
ナイコウ	内向
ギョウカイ	業界
ヨワキ	弱気
セカイ	世界
セイカイ	政界
キュウビョウ	急病
シジ	支持
シシャ	支社
シシュツ	支出
ヤム	病む
ナサケ	情け
ドアイ	度合い
ツトメ	務め
コクサン	国産
サンギョウ	産業
サンチ	産地
シュッサン	出産
セイサン	生産
フドウサン	不動産
ムスブ	結ぶ
ケッセイ	結成
ウラグチ	裏口
チュウジツ	忠実
マメ	忠実
ヒャク	百
マエバライ	前払い
ハデ	派手
リッパ	立派
チテン	地点
テン	点
テンスウ	点数
エンリョ	遠慮
キョウイン	教員
キョウカイ	教会
デアウ	出合う
ザッソウ	雑草
ココロミル	試みる
モトモト	元々
ケイザイ	経済
モノタリナイ	物足りない
ケイザイテキ	経済的
チガウ	違う
ショキ	書記
サワグ	騒ぐ
ダイブツ	大仏
ケス	消す
セイフ	政府
チメイテキ	致命的
ヨクチョウ	翌朝
ヨクアサ	翌朝
カツドウ	活動
カッパツ	活発
カツヨウ	活用
カツリョク	活力
セイカツ	生活
ゲンサク	原作
ゲンシリョク	原子力
ゲンテン	原点
ゲンリ	原理
ハレ	晴れ
サキニ	先に
センゲツ	先月
センシンコク	先進国
センセイ	先生
センジツ	先日
フクヨウ	服用
キョウツウ	共通
コウキョウ	公共
ジュウコウギョウ	重工業
キョウドウ	共同
シュトク	取得
ココロエル	心得る
トクイ	得意
カイケツ	解決
カイタイ	解体
ケンカイ	見解
リカイ	理解
ワカイ	和解
オマエ	お前
シメイ	氏名
ハイレツ	配列
ホンミョウ	本名
メイサク	名作
メイジン	名人
ナマエ	名前
メイモク	名目
ヨリカカル	寄り掛かる
ガイコウ	外交
コウツウ	交通
コッコウ	国交
セイボ	歳暮
コウタイ	交代
シキン	資金
シサン	資産
シホン	資本
ジガ	自我
ヨセン	予選
ヨテイ	予定
ヨホウ	予報
ヨヤク	予約
エンバン	円盤
オガワ	小川
カワ	川
フウシ	風刺
ムキ	向き
コウジョウ	向上
マエムキ	前向き
ドウコウ	動向
ヒッシャ	筆者
ホウコウ	方向
イコウ	意向
コクサイ	国際
コクサイカ	国際化
コクサイテキ	国際的
サイ	際
キワダツ	際立つ
ジッサイ	実際
ネル	寝る
チョウサ	調査
ケッショウ	決勝
アラワス	現す
マサル	勝る
カチ	勝ち
イチメン	一面
ウケトリ	受取り
ウケトリ	受取
ウケトリ	受け取
バメン	場面
ゼンメンテキ	全面的
テンキョ	転居
ニュウヨク	入浴
ヒョウメン	表面
ホウメン	方面
メンカイ	面会
ツラ	面
オモテ	面
メン	面
イイン	委員
イインカイ	委員会
ゲンコク	原告
ヒロメル	広める
ツゲル	告げる
フジョウリ	不条理
ホオン	保温
ホウコク	報告
アタタマル	温まる
キハン	規範
カメン	仮面
グン	軍
グンジ	軍事
グンジン	軍人
タカラクジ	宝くじ
ホウセキ	宝石
サクブン	作文
ブンカ	文化
ブンガク	文学
ブンメイ	文明
ブンショ	文書
ホンブン	本文
ホンモン	本文
ドウトク	道徳
ハンセン	反戦
ハンタイ	反対
ハンパツ	反発
ナリユキ	成行き
モト	元
ゲンキ	元気
ゲンシュ	元首
ガンジツ	元日
テモト	手元
ジモト	地元
ヒニク	皮肉
オモサ	重さ
カサネル	重ねる
ジュウシン	重心
ジュウダイ	重大
ジュウテン	重点
ジュウヨウ	重要
タイジュウ	体重
チョウホウケイ	長方形
ニジュウ	二重
フタエ	二重
ハクチョウ	白鳥
オモミ	重み
ワレメ	割れ目
マヂカ	間近
リョウシ	漁師
チカイ	近い
キンダイ	近代
サイキン	最近
セイザ	星座
マルイ	円い
セン	千
キョウリ	郷里
カンガエ	考え
カンガエル	考える
シコウ	思考
ハンケツ	判決
ハンジ	判事
ハンテイ	判定
コウニン	公認
カク	画
ガカ	画家
ガメン	画面
キリツ	起立
ムジョウ	無情
カッキテキ	画期的
ゲヒン	下品
ウミ	海
カイガイ	海外
カイグン	海軍
カイジョウ	海上
コサメ	小雨
フトクイ	不得意
イイワケ	言い訳
サンカ	参加
サンギイン	参議院
サンコウ	参考
ハキ	破棄
ウル	売る
ハツバイ	発売
ウリバ	売り場
キンリ	金利
ケンリ	権利
ショウリ	勝利
フリ	不利
リシ	利子
リヨウ	利用
タタカウ	戦う
マゴコロ	真心
クミアイ	組合
ヒトトオリ	一通り
クマ	熊
シル	知る
チジ	知事
チジン	知人
チテキ	知的
ツウチ	通知
ヨチ	予知
シリアイ	知り合い
アンナイ	案内
レンソウ	連想
カワラ	川原
コクドウ	国道
ショドウ	書道
ジンドウテキ	人道的
チュウドウ	中道
ミチ	道
ホウドウ	報道
ジシン	自信
ジュシン	受信
シンヨウ	信用
ツウシン	通信
ハッシン	発信
フシン	不信
シン	信
セイサク	政策
タイサク	対策
トクギ	特技
スゴス	過ごす
アツマル	集まる
アツメル	集める
シュウカイ	集会
シュウゴウ	集合
シュウチュウ	集中
テノヒラ	手のひら
アツマリ	集まり
ゲンザイ	現在
ザイガク	在学
ザイニチ	在日
ジュウショウ	重症
フザイ	不在
ジケン	事件
コウダン	公団
シュウダン	集団
ワラウ	笑う
ダンケツ	団結
ダンタイ	団体
ダンチ	団地
キシツ	気質
カタギ	気質
クベツ	区別
セイベツ	性別
ベツニ	別に
ワカレ	別れ
ベツモンダイ	別問題
ベツベツ	別々
グン	郡
ジナン	次男
ジンブツ	人物
ドウブツ	動物
ネンイリ	念入り
ウリモノ	売り物
ブッシ	物資
ブツリ	物理
ホンモノ	本物
ソクメン	側面
ウチガワ	内側
モトヅク	基づく
シュニン	主任
ニンイ	任意
ニンキ	任期
ニンム	任務
ゴウイン	強引
センザイ	洗剤
トリヒキ	取引
ヒキガネ	引き金
ヒキツヅキ	引き続き
コウシ	行使
ツカイ	使い
ツカウ	使う
シヨウ	使用
タイシ	大使
ナコウド	仲人
ツマル	詰まる
キュウジン	求人
イタス	致す
ヨウキュウ	要求
ウチケス	打ち消す
ニセ	偽
キンジョ	近所
ジムショ	事務所
モチナオス	持ち直す
ショトク	所得
バショ	場所
クダス	下す
ジカイ	次回
ジゲン	次元
シダイニ	次第に
カイスイ	海水
ミズ	水
スイデン	水田
スイドウ	水道
スイメン	水面
ミトメル	認める
スイサン	水産
コウハン	後半
タイハン	大半
ハン	半
ナカバ	半ば
ハンスウ	半数
ハンブン	半分
ハンメン	半面
タナバタ	七夕
ゼンハン	前半
ハントシ	半年
ハンネン	半年
タトエ	例え
タトエル	例える
サクヒン	作品
オカス	侵す
ニチヨウヒン	日用品
ブヒン	部品
オマイリ	お参り
サクネン	昨年
マイル	参る
カタホウ	片方
ギロン	議論
ケツロン	結論
ゲンロン	言論
コウフ	公布
ハンロン	反論
フタシカ	不確か
リロン	理論
ロンブン	論文
ロンリ	論理
セロン	世論
ヨロン	世論
カケイ	家計
カイケイ	会計
ケイ	計
ケイカク	計画
ゴウケイ	合計
トケイ	時計
シャセイ	写生
セッケイ	設計
トウケイ	統計
バクロ	暴露
ウツル	映る
シシャ	死者
シタイ	死体
リョウガエ	両替
ナイショク	内職
メンゼイ	免税
ミズシラズ	見ず知らず
サイマツ	歳末
ゾウカ	増加
ゾウダイ	増大
ノガレル	逃れる
メイアン	名案
スエッコ	末っ子
ヒマシニ	日増しに
オマモリ	お守り
マワリミチ	回り道
カンケイ	関係
キュウソク	休息
ドマ	土間
カカリ	係
ハテシナイ	果てしない
カンジ	感じ
カンジル	感じる
カンシン	感心
カンドウ	感動
キョウカン	共感
ジッカン	実感
タチアガル	立ち上がる
リンジン	隣人
ガイスル	害する
トクニ	特に
トクシュウ	特集
トクテイ	特定
トクベツ	特別
カンジョウ	感情
ジジョウ	事情
ジョウ	情
ジョウホウ	情報
ドウジョウ	同情
ヒョウジョウ	表情
ジツジョウ	実情
トウシ	投資
トウショ	投書
ドウハン	同伴
シジ	指示
シメス	示す
ビヨウイン	美容院
リキム	力む
アイカワラズ	相変わらず
タイヘン	大変
カワル	変わる
ヘンカ	変化
ヘンドウ	変動
ヒロガル	広がる
オトコ	男
オトコノコ	男の子
ダンシ	男子
ダンジョ	男女
ダンセイ	男性
チョウナン	長男
モドス	戻す
キチ	基地
キホン	基本
オシエル	教える
ハレツ	破裂
シリツ	私立
ヒキワケ	引分け
スム	済む
コトリ	小鳥
カザリ	飾り
カザル	飾る
ソウショク	装飾
ムケイ	無形
ヒキダシ	引出し
シタガキ	下書き
カイシ	開始
マルミ	円み
ハジマリ	始まり
ミノウエ	身の上
カシ	貸し
シマ	島
ハントウ	半島
ショウジキ	正直
タダチニ	直ちに
チョクゴ	直後
チョクゼン	直前
ツイヤス	費やす
トリハズス	取り外す
リョウシャ	両者
リョウテ	両手
リョウホウ	両方
リョウメン	両面
キヅク	気付く
コウツゴウ	好都合
アサ	朝
アサヒ	朝日
カイカク	改革
カクシン	革新
カワ	革
ムシン	無心
ウテン	雨天
チカ	地価
テイカ	定価
ノウコウ	濃厚
ノウシュク	濃縮
ブッカ	物価
ベイカ	米価
マンビキ	万引き
カクイ	各位
コウシキ	公式
セイシキ	正式
ゾウヨ	贈与
タシカメル	確かめる
カクジツ	確実
カクテイ	確定
カクニン	確認
カクホ	確保
カクリツ	確立
ハジメ	初め
メイカク	明確
コウリ	小売り
タシカ	確か
クイトメル	食い止める
ムラ	村
タツ	経つ
ショウカイ	照会
ゼンテイ	前提
テイアン	提案
テイシュツ	提出
コヅツミ	小包
ウン	運
ハコブ	運ぶ
ウンドウ	運動
ウンヨウ	運用
テイタク	邸宅
ニリュウ	二流
サイシュウ	最終
オエル	終える
シュウシ	終始
シュウセン	終戦
オワリ	終わり
センキョ	選挙
サイチュウ	最中
クダモノ	果物
カイコ	回顧
ケッカ	結果
セイカ	成果
ハタシテ	果たして
ケンメイ	賢明
ニシ	西
セイブ	西部
トウザイ	東西
ホクセイ	北西
イタン	異端
エキタイ	液体
スギル	過ぎる
アラワレル	現れる
アラワレル	現われる
ジョウセイ	情勢
イキオイ	勢い
セイリョク	勢力
ドウジョウ	同上
ミョウジ	名字
カゲン	加減
ガイメン	外面
ヘラス	減らす
ヘル	減る
ウケモチ	受け持ち
ダイ	台
ダイドコロ	台所
シラベル	調べる
リョウシュウ	領収
ヒロイ	広い
ヒロサ	広さ
ヒロマル	広まる
コウコク	広告
ヒロバ	広場
コウダイ	広大
ワライゴエ	笑い声
ウデドケイ	腕時計
ヒロゲル	広げる
シイレル	仕入れる
ナイヨウ	内容
イルイ	衣類
セイショ	聖書
カナラズ	必ず
カナラズシモ	必ずしも
ヒツヨウ	必要
ヒッシ	必死
イチオウ	一応
オウジル	応じる
オウヨウ	応用
ゴジュウオン	五十音
タイオウ	対応
チャイロ	茶色
ハンノウ	反応
テイオン	低音
エンシュツ	演出
コウエン	公演
シュエン	主演
シュツエン	出演
ジョウエン	上演
クサバナ	草花
ソクザ	即座
アジワウ	味わう
サン	酸
オモンジル	重んじる
デンキ	電気
デンシ	電子
デンリョク	電力
デンワ	電話
ハツデン	発電
ハツデンショ	発電所
マチガエル	間違える
ナカヨシ	仲良し
イキチガイ	行き違い
マチガウ	間違う
ジュウショ	住所
ジュウミン	住民
バチ	罰
イッコウ	一行
イチギョウ	一行
エンセン	沿線
ミワタス	見渡す
センソウ	戦争
アラソイ	争い
タチナオル	立ち直る
ロンソウ	論争
ミドコロ	見所
カイダン	会談
ミオロス	見下ろす
ショウドウ	衝動
ソウダン	相談
ダンワ	談話
ナカツギ	中次ぎ
ムシンケイ	無神経
キノウ	機能
ニカヨウ	似通う
セイノウ	性能
ノウ	能
ノウリョク	能力
ケイカイ	軽快
フカイ	不快
ブジ	無事
ムジン	無人
ムリ	無理
ムリョク	無力
ユウヒ	夕日
フタタビ	再び
サイカイ	再開
サイサン	再三
サイセイ	再生
ナワバリ	縄張り
オンナラシイ	女らしい
センゾ	先祖
チイ	地位
ブンゴ	文語
デキアガル	出来上がる
セッチ	設置
イチ	位置
キカク	企画
キギョウ	企業
ヘイコウ	平行
ユウグレ	夕暮れ
キキョウ	帰京
トリクム	取り組む
シンイ	真意
シンジツ	真実
シンソウ	真相
シンリ	真理
ケガワ	毛皮
モウフ	毛布
マンナカ	真ん中
ユルガス	揺るがす
イチリュウ	一流
コウリュウ	交流
テサグリ	手探り
ハリガネ	針金
シリアウ	知合う
ナガス	流す
ナガレ	流れ
リュウツウ	流通
ミドリイロ	緑色
カカク	価格
コウシ	格子
ゴウカク	合格
シカク	資格
ジンカク	人格
セイカク	性格
ホンカクテキ	本格的
アズケル	預ける
ショユウ	所有
ココロヅヨイ	心強い
トクユウ	特有
ユウケンシャ	有権者
ウム	有無
ユウメイ	有名
ユウリョク	有力
ヒヤケ	日焼け
ユウリ	有利
ウタガイ	疑い
ギモン	疑問
シンジル	信じる
ヨウギシャ	容疑者
クチ	口
デグチ	出口
ジンコウ	人口
ナヤム	悩む
イリグチ	入り口
スギ	過ぎ
カハンスウ	過半数
ケイカ	経過
ショウスル	称する
セイシ	制止
ツウカ	通過
カエス	返す
キョク	局
ケッキョク	結局
シキョク	支局
セイキョク	政局
トウキョク	当局
セボネ	背骨
ヨクシツ	浴室
ヤキニク	焼き肉
ゲンショウ	減少
スコシ	少し
ショウスウ	少数
ショウネン	少年
タショウ	多少
ショウジョ	少女
スクナクトモ	少なくとも
イクジ	意気地
カイホウ	解放
カイホウ	開放
キニイル	気に入る
ホウル	放る
モハン	模範
カンゼイ	関税
コクホウ	国宝
ゼイキン	税金
ゾウゼイ	増税
ホウテイシキ	方程式
ケンサ	検査
ケンジ	検事
ケンテイ	検定
コトガラ	事柄
ショウスウテン	小数点
テンケン	点検
ヒトリゴト	独り言
マンゲツ	満月
キイロ	黄色
ミチル	満ちる
フクム	含む
オドロカス	驚かす
ホノオ	炎
シタマチ	下町
アカス	明かす
メイロ	迷路
マチ	町
インリョク	引力
ツネニ	常に
セイジョウ	正常
ネウチ	値打ち
ツウジョウ	通常
ニチジョウ	日常
フウ	封
ヒキアゲル	引上げる
ヒキウケル	引き受ける
ヒキサゲル	引下げる
ガッコウ	学校
コウチョウ	校長
コウコウ	高校
コウコウセイ	高校生
ショウガッコウ	小学校
チュウガッコウ	中学校
ゲンリョウ	原料
シリョウ	資料
ムリョウ	無料
ユウリョウ	有料
リョウキン	料金
リョウリ	料理
スナハマ	砂浜
サイバン	裁判
サイバンショ	裁判所
トリアゲル	取り上げる
セイサイ	制裁
ソウサイ	総裁
エンブン	塩分
ゲンジョウ	現状
オオミズ	大水
ミズイラズ	水入らず
カコウ	加工
オキル	起きる
コウガク	工学
コウギョウ	工業
コウサク	工作
コウジ	工事
ジンコウ	人工
ダイク	大工
ナゴム	和む
ケンセツ	建設
タテモノ	建物
サイケン	再建
ブキヨウ	不器用
フウサ	封鎖
タテマエ	建前
ガイコクゴ	外国語
ゲンゴ	言語
カタル	語る
ゴガク	語学
コウカ	硬貨
コクゴ	国語
シュカン	主観
フチャク	付着
モノガタリ	物語
モノガタル	物語る
トジル	閉じる
ヨウゴ	用語
キゾウ	寄贈
キュウ	球
ゲッコウ	月光
チキュウ	地球
ヤキュウ	野球
ユイショ	由緒
メイゲツ	名月
ウンエイ	運営
イトナム	営む
エイギョウ	営業
カンショク	間食
ケイエイ	経営
コクエイ	国営
ヒラタイ	平たい
クウ	食う
トトノウ	整う
クウカン	空間
クウキ	空気
クウグン	空軍
カラテ	空手
クウチュウ	空中
ゲキレイ	激励
ジョウクウ	上空
マジメ	真面目
ワルモノ	悪者
ショクイン	職員
ショクギョウ	職業
ショクバ	職場
ショクニン	職人
ショクム	職務
テキタイ	敵対
ムショク	無職
ケンショウ	検証
ハグルマ	歯車
サカヤ	酒屋
ショウショ	証書
ショウメイ	証明
ホショウニン	保証人
ヨウシュ	洋酒
ホショウ	保証
コクド	国土
オモイアガル	思い上がる
スイヘイセン	水平線
タイノウ	滞納
ツチ	土
トチ	土地
リョウド	領土
ヨワイ	弱い
ビョウジャク	病弱
ヨトウ	与党
ヒキイル	率いる
キュウ	急
キュウコウ	急行
キュウセイ	急性
キュウゾウ	急増
トッキュウ	特急
ウケトメル	受け止める
チクセキ	蓄積
チュウシ	中止
リョウハシ	両端
ウメタテ	埋め立て
ミオクリ	見送り
ミオクル	見送る
オクル	送る
ソウキン	送金
ヒンプ	貧富
ホウソウ	放送
ウンソウ	運送
オウエン	応援
コウエン	後援
シエン	支援
トモ	供
サクセイ	作製
テイキョウ	提供
イフク	衣服
カノウ	可能
サシズ	指図
ショウニン	小人
コビト	小人
ズヒョウ	図表
ニンカ	認可
フカノウ	不可能
ナンテ	何て
サル	去る
ゲンエキ	現役
シヤクショ	市役所
シュヤク	主役
オトコラシイ	男らしい
ヒルスギ	昼過ぎ
ヒルヤスミ	昼休み
チュウヤ	昼夜
ビョウヨミ	秒読み
ヤク	役
ヤクシャ	役者
ヤクショ	役所
ヤクニン	役人
ヤクメ	役目
キコウ	機構
ケッコウ	結構
コウセイ	構成
コウオン	高音
チャノマ	茶の間
ナガツヅキ	長続き
サンセキ	山積
ミナサマ	皆様
シヨウ	私用
ソウモク	草木
クサキ	草木
ワリダス	割り出す
マケル	負ける
ブンカツ	分割
ヤクワリ	役割
ワリ	割り
ワリアイ	割合
ワリビキ	割引
シンブン	新聞
シンブンシャ	新聞社
キカス	聞かす
キキテ	聞き手
ノミミズ	飲み水
ジシン	自身
シュッシン	出身
ショバツ	処罰
シンシン	心身
ミモト	身元
シンチョウ	身長
ミブン	身分
モウケル	設ける
ゼンシン	全身
ナカミ	中身
カイヒ	会費
ケイヒ	経費
コクヒ	国費
ヒヨウ	費用
ナオス	直す
タクス	託す
コウフ	交付
セイテン	晴天
ソウフ	送付
ヒヅケ	日付
フチュウイ	不注意
ツキアイ	付き合い
フキン	付近
トル	撮る
シセツ	施設
ジッシ	実施
シコウ	施行
イッサイ	一切
カイソク	快速
コギッテ	小切手
キリ	切り
キッテ	切手
タイセツ	大切
オモイキッテ	思い切って
ケイユ	経由
ジユウ	自由
テブクロ	手袋
フジユウ	不自由
ヨシ	由
リユウ	理由
ヤトウ	雇う
エンゼツ	演説
カイセツ	解説
ガクセツ	学説
ショウセツ	小説
セットク	説得
セツメイ	説明
テンサイ	天災
タハタ	田畑
カタミチ	片道
ジョセイテキ	女性的
ウンテン	運転
ウンテンシュ	運転手
カイテン	回転
カケ	掛け
カンシュウ	慣習
ハヤオキ	早起き
ガイショク	外食
ケイエン	敬遠
タベモノ	食べ物
ショクジ	食事
ショクヒン	食品
ショクリョウ	食料
チョウショク	朝食
ヒメイ	悲鳴
クラベル	比べる
ユル	揺る
ムズカシイ	難しい
ナンミン	難民
ナンモン	難問
コクボウ	国防
セキセツ	積雪
モッパラ	専ら
オオユキ	大雪
ボウシ	防止
ヨボウ	予防
アズカル	預かる
ヒッキ	筆記
ホキョウ	補強
バイウ	梅雨
ゲシャ	下車
ガイシャ	外車
キカンシャ	機関車
ジテンシャ	自転車
ジドウシャ	自動車
クルマ	車
シャナイ	車内
シャリョウ	車両
センシャ	戦車
デンシャ	電車
リンカ	隣家
キタカゼ	北風
ガヨウシ	画用紙
ジョユウ	女優
ユウショウ	優勝
ユウセン	優先
ギレイ	儀礼
クフウ	工夫
フジン	夫人
レイギ	礼儀
ドウソウカイ	同窓会
カイシュウ	回収
ツヨマル	強まる
シュウシ	収支
シュウニュウ	収入
シュウヨウ	収容
スイトウ	出納
ネンシュウ	年収
ビカ	美化
シュウシュウ	収集
ソナエル	供える
ケツダン	決断
コトワル	断る
ハンダン	判断
ヨダン	予断
シボル	絞る
ホド	程
ハナシコトバ	話し言葉
ナニカ	何か
ナント	何と
ナントカ	何とか
ナニヨリ	何より
ナントモ	何とも
ナンド	何度
ジンドウシュギ	人道主義
オソワル	教わる
ヤマノボリ	山登り
ミナミ	南
ナンブ	南部
ナンボク	南北
ナンセイ	南西
ナントウ	南東
カセキ	化石
ミョウネン	明年
ヒキトル	引取る
テアシ	手足
アシ	足
フソク	不足
ボウチョウ	膨張
ホッソク	発足
アシモト	足元
フクレル	膨れる
ワリニ	割に
チガイ	違い
イハン	違反
イホウ	違法
マチガイ	間違い
ソウイ	相違
リュウコウカ	流行歌
カイショウ	解消
タエル	耐える
ショウヒ	消費
ショウヒシャ	消費者
ショウボウ	消防
トリケシ	取り消し
オチコボレ	落ちこぼれ
サカイ	境
キョウカイ	境界
コッキョウ	国境
シンキョウ	心境
ツイトツ	追突
ツイデ	次いで
ウケツケル	受け付ける
カミ	神
シンケイ	神経
ジンジャ	神社
シンワ	神話
ミツカル	見付かる
イチバン	一番
バングミ	番組
ホンバン	本番
キセイ	規制
キテイ	規定
コウハク	紅白
シンキ	新規
セイキ	正規
ムショウニ	無性に
シュジュツ	手術
モウシワケ	申し訳
キセル	着せる
ホゴ	保護
ホゴシャ	保護者
ヒカル	光る
テンカイ	展開
テンジ	展示
ハッテン	発展
コロブ	転ぶ
ノリバ	乗り場
ヒトニギリ	一握り
ツナワタリ	綱渡り
マゼル	交ぜる
ジッタイ	実態
ジョウタイ	状態
タイセイ	態勢
タイド	態度
イケバナ	生け花
キキメ	利き目
ジタイ	事態
シドウ	指導
ハヤス	生やす
ドウニュウ	導入
ハンドウタイ	半導体
ソウシュン	早春
アクイ	悪意
ヨコガキ	横書き
ケンドウ	剣道
シンセン	新鮮
アザヤカ	鮮やか
ステキ	素敵
ツウジル	通じる
トバス	飛ばす
ワエイ	和英
ヒャッカジテン	百科事典
グンビ	軍備
セツビ	設備
ネンガ	年賀
ヨビ	予備
キゲン	機嫌
キラウ	嫌う
ジタク	自宅
ジュウタク	住宅
ジュウタクチ	住宅地
タクチ	宅地
カイスウケン	回数券
コウガイ	公害
ユウガイ	有害
リガイ	利害
ケハイ	気配
シハイ	支配
シンパイ	心配
ハイチ	配置
ハイトウ	配当
ハイブン	配分
ブンパイ	分配
カンビョウ	看病
ネンゴウ	年号
フクサヨウ	副作用
テスリ	手すり
アラワレ	現われ
ケイサン	計算
ケッサン	決算
ウカル	受かる
ヨサン	予算
シタジキ	下敷き
シテン	視点
シヤ	視野
ジュウシ	重視
ジュンカイ	巡回
シキブトン	敷き布団
スワル	座る
ジョウケン	条件
ジョウヤク	条約
カンジ	幹事
カンブ	幹部
コウキュウ	恒久
アオイ	青い
オオイ	多い
カナシム	悲しむ
ミキ	幹
ヒルマエ	昼前
ドクサイ	独裁
ドクジ	独自
ドクシン	独身
ドクトク	独特
ドクリツ	独立
ケイカン	警官
ケイコク	警告
ケイホウ	警報
ツミタテ	積み立て
タイセキ	体積
チャドウ	茶道
サドウ	茶道
ハンサヨウ	反作用
ムイミ	無意味
キュウメイ	究明
ケンキュウ	研究
ワリアテ	割当て
キョウイク	教育
クイチガイ	食違い
ミル	診る
タイイク	体育
ウケミ	受身
シュッセキ	出席
セキ	席
セキジョウ	席上
ウンユ	運輸
ユシュツ	輸出
ユソウ	輸送
ユニュウ	輸入
ヨウキ	陽気
タテナオス	立て直す
シタシラベ	下調べ
アラタマル	改まる
タズネル	訪ねる
ホウモン	訪問
タノシミ	楽しみ
コウラク	行楽
ココロヨイ	快い
カイセイ	快晴
コウサ	交差
サシアゲル	差し上げる
サイキ	再起
ジョウギ	定規
ナワ	縄
ソセン	祖先
チャクジツ	着実
キモノ	着物
ノリクミイン	乗組員
ジョウヨウシャ	乗用車
ケイロウ	敬老
シテン	支店
ショテン	書店
テンイン	店員
ホンテン	本店
ジュウタイ	重態
コウリテン	小売店
キジュツ	記述
アキチ	空地
トル	捕る
トラエル	捕らえる
ノコリ	残り
ザンギョウ	残業
ザンダカ	残高
サス	指す
ハバム	阻む
ノコス	残す
カンソウ	感想
コウソウ	構想
ササル	刺さる
シソウ	思想
ソンケイ	尊敬
ハッソウ	発想
ヨソウ	予想
リソウ	理想
アル	有る
シンカンセン	新幹線
セン	線
ムセン	無線
カクリツ	確率
カケル	駆ける
コクフク	克服
オル	織る
フブキ	吹雪
ヒリツ	比率
リリツ	利率
ソッチョク	率直
ワカワカシイ	若々しい
オサマル	治まる
オサメル	治める
ビョウイン	病院
ビョウキ	病気
ビョウシ	病死
シンダイ	寝台
デイリグチ	出入口
イッパイ	一杯
ケイド	経度
ノウカ	農家
ノウキョウ	農協
ノウギョウ	農業
ノウジョウ	農場
ノウソン	農村
ノウチ	農地
ノウミン	農民
タチドマル	立ち止まる
シュウ	州
タシザン	足し算
カクセイキ	拡声機
チョクシ	直視
ブリョク	武力
ナマイキ	生意気
コエ	声
セイメイ	声明
シツ	質
シツモン	質問
ヒトジチ	人質
セイシツ	性質
タイシツ	体質
ヒンシツ	品質
ブッシツ	物質
ホンシツ	本質
ハッパ	葉っぱ
キネン	記念
キネンビ	記念日
ザンネン	残念
シンネン	信念
ダンネン	断念
ニュウネン	入念
ウスグライ	薄暗い
リネン	理念
イレモノ	入れ物
バケモノ	化け物
キタイ	期待
シチヤ	質屋
ヤオヤ	八百屋
カエス	反す
キビン	機敏
ココロミ	試み
シアイ	試合
ニュウシ	入試
カゾク	家族
テビキ	手引
ヒキダス	引出す
ミンゾク	民族
アタイスル	値する
キショウ	気象
ギョソン	漁村
ゲンショウ	現象
タイショウ	対象
ダイベン	代弁
ギンコウ	銀行
ギン	銀
クイキ	区域
ジカツ	自活
チイキ	地域
リョウイキ	領域
エンジョ	援助
ガンコ	頑固
トリツグ	取り次ぐ
タスケル	助ける
ジョシュ	助手
ホジョ	補助
カロウ	過労
コウチャ	紅茶
アラス	荒らす
アレル	荒れる
オモイキル	思い切る
ジョウレイ	条例
ゼンレイ	前例
ヒレイ	比例
タトエバ	例えば
レイガイ	例外
レイネン	例年
レイ	例
エイセイ	衛生
ジエイ	自衛
ボウエイ	防衛
シゼン	自然
シュカンテキ	主観的
トウゼン	当然
ジョウジル	乗じる
ソウキ	早期
ソウチョウ	早朝
ハヤメル	早める
カメ	亀
シュチョウ	主張
シュッチョウ	出張
ハカル	計る
エイガ	映画
ジョウエイ	上映
アクジョ	悪女
キゲン	期限
ケンゲン	権限
カギル	限る
ゲンカイ	限界
ゲンテイ	限定
ゲンド	限度
サイショウゲン	最小限
セイゲン	制限
ツラナル	連なる
サイダイゲン	最大限
ハブラシ	歯ブラシ
オヤ	親
オヤコ	親子
シンゾク	親族
ジンブンカガク	人文科学
リョウシン	両親
キンガク	金額
スミ	炭
オモイガケナイ	思いがけない
カンシ	監視
イイダス	言い出す
ジョウシャケン	乗車券
オクレ	遅れ
カンキョウ	環境
ケイケン	経験
シケン	試験
ジッケン	実験
ジュケン	受験
タイケン	体験
ボクジョウ	牧場
ゴウジョウ	強情
ミスゴス	見過ごす
オウ	追う
ツイカ	追加
ツイホウ	追放
マズシイ	貧しい
マイド	毎度
ササヤカ	細やか
シンギ	審議
シンパン	審判
フシン	不審
ヨウショク	養殖
ナガラク	長らく
ショウギョウ	商業
ショウシャ	商社
ショウテン	商店
ショウバイ	商売
ショウヒン	商品
コトバ	言葉
アオザメル	青ざめる
ユカタ	浴衣
ウチアケル	打ち明ける
マッサオ	真っ青
イギ	意義
ギム	義務
キョウサンシュギ	共産主義
シホンシュギ	資本主義
シュギ	主義
セイギ	正義
ヒルネ	昼寝
テイギ	定義
メイギ	名義
ツタワル	伝わる
デンセツ	伝説
デントウ	伝統
アミモノ	編み物
チャワン	茶わん
キュウコウ	休校
ハタラキ	働き
ロウドウシャ	労働者
ロウドウ	労働
カタチ	形
ケイシキ	形式
ケイセイ	形成
テガタ	手形
ニンギョウ	人形
タダス	正す
ケイキ	景気
クイチガウ	食い違う
トム	富む
オチル	落ちる
カキナオス	書き直す
セイオウ	西欧
チョクシン	直進
トウオウ	東欧
ヒジョウシキ	非常識
トビオリル	飛び降りる
タスカル	助かる
カンヌシ	神主
タントウ	担当
タンニン	担任
タンポ	担保
ブンタン	分担
コノミ	好み
コウイ	好意
コウチョウ	好調
コウブツ	好物
ダイスキ	大好き
カッコウ	格好
インタイ	引退
カイラク	快楽
サシダス	差し出す
タイジ	退治
タイショク	退職
チュウタイ	中退
ロウドク	朗読
ジュンビ	準備
ジョウタツ	上達
スイジュン	水準
キジュン	基準
コウザン	鉱山
ショウ	賞
ショウキン	賞金
ニュウショウ	入賞
カタガワ	片側
キソ	起訴
アラワレル	表れる
ウッタエ	訴え
ハヤマル	早まる
ヘン	辺
オオウ	覆う
カイゾウ	改造
コウゾウ	構造
クミタテル	組み立てる
モクゾウ	木造
エイゴ	英語
ヒトミシリ	人見知り
ユキドケ	雪解け
ヒガイ	被害
ヒコク	被告
フシマツ	不始末
カブ	株
カブシキ	株式
カブヌシ	株主
カンカク	間隔
ツユアケ	梅雨明け
ダボク	打撲
ネントウ	念頭
セントウ	先頭
カザカミ	風上
エンギ	演技
ワザ	技
ギジュツ	技術
ギノウ	技能
シュクフク	祝福
トックン	特訓
サイテイ	最低
テイカ	低下
ゲンソ	元素
モトモト	本々
マイニチ	毎日
アビセル	浴びせる
イガク	医学
イシャ	医者
キンシ	近視
コジ	故事
カイフク	回復
シソン	子孫
ウチキ	内気
フッカツ	復活
オバケ	お化け
シゴト	仕事
ニュウジ	乳児
ハセイ	派生
フカカイ	不可解
シカタ	仕方
シクミ	仕組み
ジモン	自問
カコ	過去
キョネン	去年
シキョ	死去
メイズル	命ずる
カンショウ	鑑賞
スガタ	姿
シセイ	姿勢
ハンコウ	反抗
イミ	意味
キミ	気味
ジミ	地味
アジ	味
ミカタ	味方
タダ	唯
カタミ	形見
ショウブ	勝負
マケ	負け
フタン	負担
アトガキ	後書き
ソカク	組閣
ナイカク	内閣
スルドイ	鋭い
ミナリ	身なり
ニッカン	日韓
ミズイロ	水色
チャクショク	着色
ナンイ	難易
カシツ	過失
チカヅケル	近付ける
スコヤカ	健やか
ウシナウ	失う
シツギョウ	失業
テッキョウ	鉄橋
モウレツ	猛烈
イテン	移転
イドウ	移動
イミン	移民
カクサ	格差
クチベニ	口紅
サベツ	差別
ウケル	請ける
モノサシ	物差し
コウヨウ	紅葉
キカン	器官
ゲンコウヨウシ	原稿用紙
ゴサ	誤差
シュウギイン	衆議院
タイシュウ	大衆
チョウジョウ	頂上
ミンシュウ	民衆
カタマリ	塊
ヨコガオ	横顔
コジン	個人
コセイ	個性
アサガオ	朝顔
ココ	個々
カタサ	硬さ
セイモン	正門
ゾンジル	存じる
ニュウモン	入門
ブモン	部門
メイモン	名門
クワダテル	企てる
ゲッショク	月食
シャシン	写真
ジンゾウ	人造
ヒョウ	評
ヒョウカ	評価
ヒョウバン	評判
ヒョウロン	評論
ハゲマス	励ます
アクジ	悪事
カゼイ	課税
カダイ	課題
カチョウ	課長
ニッカ	日課
サガス	探す
アトシマツ	後始末
ネンマツ	年末
マッキ	末期
マモル	守る
シュビ	守備
ホシュ	保守
ギャッキョウ	逆境
キンギョ	金魚
ワカモノ	若者
カガヤカシイ	輝かしい
クチダシ	口出し
シュノウ	首脳
ノウ	脳
ノウシ	脳死
リコウ	利口
エキ	液
ショウキョクテキ	消極的
ナンキョク	南極
イッシュ	一種
シュモク	種目
ジンシュ	人種
ナゲル	投げる
ヒンシュ	品種
ウツクシイ	美しい
ビジュツ	美術
ヒニン	避妊
ウデマエ	腕前
ハナシゴエ	話し声
ミジカイ	短い
カゲ	影
ウンメイ	運命
カクメイ	革命
シメイ	使命
シンセイ	神聖
セイメイ	生命
ニンメイ	任命
ネムリ	眠り
イノチ	命
メイニチ	命日
ダンセイテキ	男性的
モノオト	物音
ツカイステ	使い捨て
コウキシン	好奇心
モウシデル	申し出る
ガマン	我慢
カサナル	重なる
オオクラ	大蔵
ネンリン	年輪
ヤスイ	安い
オヨボス	及ぼす
ジュウリョウ	重量
スウリョウ	数量
タイリョウ	大量
チュウドク	中毒
キエル	消える
テンボウ	展望
ノゾミ	望み
ヨウボウ	要望
ウチケシ	打ち消し
オモイナオス	思い直す
マツ	松
ハメツ	破滅
ヒナン	非難
ヒジョウ	非常
ダゲキ	打撃
ハンゲキ	反撃
モクゲキ	目撃
サシツカエル	差し支える
バンネン	晩年
ナラブ	並ぶ
サシツカエ	差し支え
ホサ	補佐
カク	核
ケッカク	結核
ネッスル	熱する
ハクネツ	白熱
ホウガイ	法外
チュウカク	中核
サケブ	叫ぶ
カンサツ	観察
ケイサツ	警察
ツキハジメ	月初め
ケンサツ	検察
アラワス	表わす
シサツ	視察
シサ	示唆
セイビ	整備
セイリ	整理
チョウセイ	調整
イチダン	一段
シュダン	手段
ウツス	映す
ヒキハナス	引き離す
ヨコ	横
オウダン	横断
キンユウ	金融
シジュウ	始終
カタ	型
オオガタ	大型
コガタ	小型
メイハク	明白
イップウ	一風
オドス	脅す
クウハク	空白
コクメイ	克明
シロ	白
ハクショ	白書
ハクジン	白人
カザシモ	風下
ボクメツ	撲滅
オボエル	覚える
カツジ	活字
アラワス	現わす
スウジ	数字
モジドオリ	文字通り
チョッケイ	直径
カイトウ	回答
コタエ	答え
モンドウ	問答
ヒマ	暇
オイツク	追い付く
セイサン	成算
モリアゲル	盛り上げる
ゼンヤ	前夜
ヤワラカ	柔らか
ヨル	夜
ヤカン	夜間
セイサク	製作
セイゾウ	製造
セイヒン	製品
トウヒョウ	投票
ヒョウ	票
コノハ	木の葉
ジョウキョウ	状況
フキョウ	不況
ヤクダツ	役立つ
オンガク	音楽
オンセイ	音声
キンキョリ	近距離
ケツエン	血縁
フソウオウ	不相応
ホンネ	本音
シンコク	申告
トウシン	答申
ツメタイ	冷たい
ワリアテル	割り当てる
カミサマ	神様
タヨウ	多様
ドウヨウ	同様
フクラム	膨らむ
ヨウス	様子
ヨウシキ	様式
ヨウソウ	様相
サマザマ	様々
ザイカイ	財界
ザイサン	財産
ザイセイ	財政
ブンカザイ	文化財
チカラモチ	力持ち
クウコウ	空港
ミナト	港
ショウガクキン	奨学金
ヤセイ	野性
イシキ	意識
ジョウシキ	常識
チシキ	知識
ニンシキ	認識
ツッパル	突っ張る
ムカシバナシ	昔話
チュウイ	注意
チュウモン	注文
チュウモク	注目
ヨブ	呼ぶ
アユミヨル	歩み寄る
コウショウ	交渉
ヒヨリ	日和
ジョウヒン	上品
タッセイ	達成
ツウタツ	通達
カイリョウ	改良
フリョウ	不良
リョウコウ	良好
エイキョウ	影響
マエオキ	前置き
ハンキョウ	反響
イチイチ	一々
ノリモノ	乗物
ヘイキ	平気
カエリ	帰り
キコク	帰国
キタク	帰宅
シヌ	死ぬ
シニン	死人
フッキ	復帰
ベンジョ	便所
ヨコギル	横切る
ハリ	針
ホウシン	方針
センム	専務
センモン	専門
センモンカ	専門家
センヨウ	専用
スイシン	推進
スイテイ	推定
トオカ	十日
シロバイ	白バイ
ハクセン	白線
タチナオル	立ちなおる
タニ	谷
コダイ	古代
キコウ	気候
モト	本
ホン	本
コウホ	候補
アキカゼ	秋風
オオモジ	大文字
リッコウホ	立候補
ナサケナイ	情けない
シジョウ	史上
ウケモツ	受け持つ
トグ	研ぐ
イノリ	祈り
ザシキ	座敷
テン	天
テンジョウ	天井
テンキ	天気
テンコウ	天候
テンゴク	天国
テンネン	天然
カイ	階
カイダン	階段
ゲンシュ	厳守
ダンカイ	段階
ニカイ	二階
ホウニン	放任
カテイ	課程
カテイ	過程
カネル	兼ねる
ギョウギ	行儀
タンショ	短所
テイド	程度
ニッテイ	日程
コノハ	木ノ葉
セイジュク	成熟
フマン	不満
マンイン	満員
マンゾク	満足
シッパイ	失敗
ショウハイ	勝敗
ハイセン	敗戦
ハイボク	敗北
ウンキュウ	運休
カンリ	管理
ショウジ	障子
ソクセキ	即席
ホカン	保管
カン	管
クダ	管
カチ	価値
スウチ	数値
アラウ	洗う
タリル	足りる
タイホウ	大砲
アタイ	値
ネアゲ	値上げ
ネサゲ	値下げ
ネダン	値段
スエオキ	据え置き
カシュ	歌手
ウラナウ	占う
ヒマン	肥満
ヒリョウ	肥料
ショウリョウ	小量
カウ	買う
バイシュウ	買収
バイバイ	売買
カイモノ	買い物
ノリオリ	乗り降り
ダンボウ	暖房
トツゼン	突然
ニセモノ	偽物
イキワタル	行き渡る
ホコル	誇る
ノビル	延びる
ダイズ	大豆
トウフ	豆腐
ナットウ	納豆
ウツル	移る
テスウ	手数
スイコウ	遂行
セッスル	接する
セッキン	接近
セッタイ	接待
チョクセツ	直接
バンチ	番地
メンセツ	面接
タイハイ	退廃
カクスウ	画数
シンセイ	申請
セイキュウ	請求
メイロウ	明朗
ヨウセイ	要請
カクヘイキ	核兵器
ガッキ	楽器
キショウ	起床
ブキ	武器
ヘイキ	兵器
ヨウキ	容器
ジョウブ	丈夫
コウギョウ	鉱業
ドウシ	同士
ヘイシ	兵士
カンコウ	観光
ヒカリ	光
コウケイ	光景
セイサン	精算
ケントウ	検討
トウギ	討議
トウロン	討論
シンロ	進路
センロ	線路
ホウムル	葬る
ドウロ	道路
ロジョウ	路上
アク	悪
アッカ	悪化
アクシツ	悪質
サイアク	最悪
メザス	目指す
カガク	科学
カガクシャ	科学者
ゲカ	外科
ガッカ	学科
キョウカショ	教科書
センネン	専念
ブンカ	文科
リカ	理科
カモク	科目
キャクシャ	客車
セメル	攻める
コウゲキ	攻撃
シュエイ	守衛
センコウ	専攻
タイテイ	大抵
カントク	監督
イワウ	祝う
キョウジュ	教授
ジュギョウ	授業
ジョキョウジュ	助教授
チカク	知覚
ハンケイ	半径
カイサイ	開催
シュサイ	主催
ウム	産む
コマカイ	細かい
メイサイ	明細
コウカ	効果
コウリツ	効率
ムコウ	無効
ユウコウ	有効
ヨウフウ	洋風
イト	意図
ズケイ	図形
トショ	図書
チズ	地図
コンシュウ	今週
シュウ	週
シュウマツ	週末
ショウダク	承諾
センシュウ	先週
マイシュウ	毎週
ライシュウ	来週
インカン	印鑑
セッキョクテキ	積極的
メンセキ	面積
カミナリ	雷
ヒノマル	日の丸
サメル	冷める
ヒケメ	引け目
タホウ	他方
タニン	他人
カン	勘
カンジョウ	勘定
オヨブ	及ぶ
ツイキュウ	追及
ラクダイ	落第
ワン	湾
キロク	記録
ムショク	無色
ロクオン	録音
ショチ	処置
ショブン	処分
ショリ	処理
タイショ	対処
カツグ	担ぐ
ツウレツ	痛烈
テンサイ	天才
ヒジョウグチ	非常口
ツケクワエル	付け加える
オトズレル	訪れる
メツキ	目付き
ミカケ	見かけ
ガイムショウ	外務省
オオクラショウ	大蔵省
ハンセイ	反省
モンブショウ	文部省
ツウサンショウ	通産省
ナイ	無い
キョウシツ	教室
シツナイ	室内
タイトク	体得
マワリ	回り
ケンポウ	憲法
センサイ	繊細
オクレ	後れ
カショ	個所
ムシバ	虫歯
ノリキ	乗気
ウッタエル	訴える
フトイ	太い
コウメイ	高名
ハシ	橋
ケイシャ	傾斜
ジュウジロ	十字路
シンポ	進歩
ホチョウ	歩調
ダンダン	段々
ヨコミチ	横道
ブンリ	分離
ハナレル	離れる
ニクイ	難い
カタイ	難い
ソウジキ	掃除機
ヒダリキキ	左利き
カイガン	海岸
キシ	岸
セントウ	銭湯
マス	増す
リュウネン	留年
カンキャク	観客
キャク	客
キャッカンテキ	客観的
キャクセキ	客席
ケンオ	嫌悪
タイケイ	体型
オギナウ	補う
メジルシ	目印
ジョウキャク	乗客
オセジ	お世辞
キョウフウ	強風
ハクジョウ	白状
フウケイ	風景
ソッセン	率先
タイフウ	台風
カミ	紙
シメン	紙面
テガミ	手紙
トダエル	途絶える
ハクシ	白紙
ヒョウシ	表紙
ヨウシ	用紙
キュウゲキ	急激
ゲキドウ	激動
チュウサンカイキュウ	中産階級
ハクランカイ	博覧会
ヒテイ	否定
ヒンジャク	貧弱
オイツク	追いつく
ホソナガイ	細長い
シュウヘン	周辺
メグリアウ	巡り会う
マワリ	周り
メダマショウヒン	目玉商品
イシ	医師
ギシ	技師
キョウシ	教師
ハナス	放す
オシツケル	押し付ける
シテキ	指摘
テキハツ	摘発
ハクイ	白衣
ザイリョウ	材料
シュザイ	取材
シンアイ	親愛
ジンザイ	人材
モクザイ	木材
カワイイ	可愛い
ナス	成す
ツモル	積もる
マチアワセル	待ち合わせる
トウコウ	登校
トザン	登山
トウジョウ	登場
トウロク	登録
ダイダイ	代代
ケイトウ	系統
タイケイ	体系
テッポウ	鉄砲
ヒハン	批判
ヒヒョウ	批評
テイケイ	定形
スジミチ	筋道
ヒトチガイ	人違い
ナンカ	軟化
オカアサン	お母さん
ハハ	母
ハハオヤ	母親
オロシウリ	卸売
アンイ	安易
コウフン	興奮
コウスイ	降水
ヨウイ	容易
ナオル	直る
トウサン	父さん
ノベ	延べ
ケンゼン	健全
トウジョウ	搭乗
ホケン	保健
クロ	黒
クロジ	黒字
コクジン	黒人
ミョウチョウ	明朝
カザン	火山
カジ	火事
ホウカ	放火
イド	井戸
カタイ	固い
コワイ	怖い
エイセイテキ	衛生的
カソク	加速
カイタク	開拓
キュウソク	急速
ゲンソク	減速
コウソク	高速
コウソクドウロ	高速道路
ジソク	時速
スミヤカ	速やか
ソクド	速度
フウソク	風速
セイゾン	生存
ソンザイ	存在
ホゾン	保存
キョウゾン	共存
ハナ	花
ハナビ	花火
テンプク	転覆
リッキャク	立脚
カエル	帰る
ハル	春
ヒソム	潜む
ブアイ	歩合
シカクイ	四角い
トオス	通す
ニュウカ	入荷
ヒコウ	飛行
ヒコウキ	飛行機
ソノホカ	その外
コロス	殺す
サツジン	殺人
ジサツ	自殺
タイヒ	退避
フシンセツ	不親切
セイソウ	正装
チュウオウ	中央
チル	散る
ショウケン	証券
シンズル	信ずる
アカチャン	赤ちゃん
アカジ	赤字
コナ	粉
ナオス	治す
クチドメ	口止め
シンゴウ	信号
サカズキ	杯
バンゴウ	番号
クジラ	鯨
タンナル	単なる
タンニ	単に
タンイ	単位
タンイツ	単一
カメイ	加盟
ラクテンテキ	楽天的
モリアガル	盛り上がる
チュウショウテキ	抽象的
ドウメイ	同盟
アンモク	暗黙
ザセキ	座席
アンセイ	安静
アオ	青
セイシュン	青春
セイネン	青年
ケンブツニン	見物人
トッパ	突破
ハサン	破産
アタリ	当り
アタリマエ	当り前
ヘンセイ	編成
テアテ	手当て
ヘンシュウ	編集
ソウサ	捜査
ヒヤカス	冷やかす
フトコロ	懐
タケ	竹
カイジョ	解除
ベンサイ	弁済
カンセイ	完成
カンゼン	完全
スム	住む
テキリョウ	適量
シュジン	主
オモ	主
シュ	主
ヌシ	主
カイテ	買手
ズイヒツ	随筆
オリル	降りる
ガンバル	頑張る
ネツレツ	熱烈
モクジ	目次
オリル	下りる
ツキアウ	付き合う
ニナウ	担う
ヒキツケル	引き付ける
セキニン	責任
コンドウ	混同
クギル	区切る
イリョウ	医療
チリョウ	治療
ツッコム	突っ込む
カイバツ	海抜
カオツキ	顔付き
ジュウギョウイン	従業員
ジュウライ	従来
サッソク	早速
フジチャク	不時着
チャクチャク	着々
ミギ	右
ミギテ	右手
ノリマワス	乗り回す
トウワク	当惑
シュウセイ	修正
シュウリ	修理
マジル	交じる
ミセビラキ	店開き
シュンブン	春分
ミクラベル	見比べる
イジワル	意地悪
グンタイ	軍隊
ジエイタイ	自衛隊
ナガレル	流れる
キムズカシイ	気難しい
キキ	危機
ソウサイ	相殺
ボウエンキョウ	望遠鏡
サイケツ	採決
サイサン	採算
サイヨウ	採用
テオクレ	手遅れ
ソシキ	組織
モリ	森
ツウチョウ	通帳
クイ	悔い
キョウギ	競技
キョウソウ	競争
サズケル	授ける
カクダイ	拡大
グンカク	軍拡
コウツウジコ	交通事故
ジコ	事故
エイガカン	映画館
オンタイ	温帯
ヒサシイ	久しい
グンカン	軍艦
トショカン	図書館
タイシカン	大使館
ビジュツカン	美術館
シアゲル	仕上げる
シカタガナイ	仕方がない
フシン	不振
ザットウ	雑踏
キュウショク	給食
キュウヨ	給与
キュウリョウ	給料
キョウキュウ	供給
ホキュウ	補給
ミジュク	未熟
オクジョウ	屋上
ノキ	軒
コヤ	小屋
ヘヤ	部屋
サガス	捜す
オン	恩
ヨミ	読み
ヨミカタ	読み方
ドクシャ	読者
ドクショ	読書
シモン	指紋
モッテイク	持って行く
トウベン	答弁
ベンゴ	弁護
ベンゴシ	弁護士
ベントウ	弁当
ヒトリジメ	独り占め
ヤネ	屋根
コンポン	根本
ネモト	根本
ワズラウ	患う
イロ	色
ワタル	渡る
トクショク	特色
キョウドウ	協同
トモ	友
ユウコウ	友好
ユウジョウ	友情
ユウジン	友人
トモダチ	友達
コエル	超える
トリシラベ	取調べ
クルシミ	苦しみ
ニガテ	苦手
クジョウ	苦情
クロウ	苦労
サス	差す
シュウショク	就職
シュウニン	就任
マイバン	毎晩
ハクハツ	白髪
シラガ	白髪
ナミ	並
コウネツヒ	光熱費
ハジ	恥
サケビ	叫び
コウブツ	鉱物
ハシル	走る
ハンバイ	販売
ソノ	園
エン	園
ガクエン	学園
コウエン	公園
ハズム	弾む
ドウブツエン	動物園
カグ	家具
カオブレ	顔触れ
グタイテキ	具体的
ドウグ	道具
グアイ	具合
ツカマエル	捕まえる
ヒダリ	左
サユウ	左右
ヒダリテ	左手
ホウガク	方角
ミンヨウ	民謡
イジョウ	異常
ゲンゾウ	現像
ガクレキ	学歴
ケイレキ	経歴
ケワシイ	険しい
オモワク	思わく
ソントク	損得
レキシ	歴史
レキシテキ	歴史的
ジショ	辞書
ジショク	辞職
ジニン	辞任
ショウグン	将軍
ショウライ	将来
ハナシアイ	話合い
キソウ	競う
マガル	曲がる
アキ	秋
ヘイオン	平穏
ボットウ	没頭
ゲンイン	原因
サイキン	細菌
フキツ	不吉
ヨウイン	要因
センテンテキ	先天的
ウラオモテ	裏表
ゲンジュウ	厳重
カキネ	垣根
ケイバ	競馬
ウマ	馬
アイ	愛
アイジョウ	愛情
エントツ	煙突
オオハバ	大幅
チコク	遅刻
ハバ	幅
ハバヒロイ	幅広い
テツヅキ	手続
ミツモリ	見積り
ヤスミ	休み
ヤスム	休む
キュウギョウ	休業
キュウジツ	休日
レンキュウ	連休
シュウキュウ	週休
イジ	維持
イシン	維新
カイギ	懐疑
カンヅメ	缶詰
キモ	肝
キョウグウ	境遇
アツイ	厚い
カンメイ	感銘
タナ	棚
トミ	富
ハカル	量る
セイケツ	清潔
ハマ	浜
オトウサン	お父さん
ツキアタル	突き当たる
チチ	父
チチオヤ	父親
フボ	父母
イサン	遺産
イタイ	遺体
カシャ	貨車
トリアゲル	取上げる
ヨセアツメ	寄せ集め
キセイ	寄生
ミグルシイ	見苦しい
カレラ	彼ら
カノジョ	彼女
イッパン	一般
エキチョウ	駅長
シュウチャクエキ	終着駅
ゼンパン	全般
ソウタイ	早退
ムノウ	無能
ヒョウザン	氷山
ミテイ	未定
ミメイ	未明
ミライ	未来
ムダ	無駄
ハナシコム	話し込む
ソクタツ	速達
チャクセキ	着席
ボウエキ	貿易
オモウゾンブン	思う存分
カンデンチ	乾電池
コウエン	講演
コウギ	講義
コウシ	講師
コウワ	講和
ナナメ	斜め
ノベル	述べる
ホウジン	邦人
レンポウ	連邦
ウム	生む
ハエル	映える
ヨコタワル	横たわる
ヨコドリ	横取り
ミマウ	見舞う
ノビヤカ	伸びやか
ブタイ	舞台
キンズル	禁ずる
シンリン	森林
ネットウ	熱湯
ノウリン	農林
ハヤシ	林
ソウチ	装置
ブソウ	武装
テイガク	停学
ロウニン	浪人
ナツ	夏
ナツヤスミ	夏休み
ソザイ	素材
シロウト	素人
スナオ	素直
ネンド	粘土
ヨウソ	要素
シボウ	死亡
ボウメイ	亡命
エンゲキ	演劇
エンソク	遠足
ゲキ	劇
ゲキジョウ	劇場
ゲキテキ	劇的
ツキヨ	月夜
ソメル	染める
カセン	河川
カワグチ	河口
カコウ	河口
セイザ	正座
ハケン	派遣
アトモドリ	後戻り
コウカイ	航海
コウクウ	航空
コウクウキ	航空機
コムギ	小麦
ナンコウ	難航
ムギ	麦
フミン	不眠
コウギ	抗議
タイコウ	対抗
オジ	伯父
キュウガク	休学
シツド	湿度
レイスイ	冷水
レイセン	冷戦
オンガエシ	恩返し
キボ	規模
ドソク	土足
モヨウ	模様
アリサマ	有様
エイユウ	英雄
ショウドク	消毒
オス	雄
サイテキ	最適
テキセツ	適切
テキトウ	適当
テキヨウ	適用
ムボウ	無謀
モチナオス	持直す
シュフ	主婦
フジン	婦人
フウフ	夫婦
ナグル	殴る
キメツケル	決め付ける
コクテツ	国鉄
シテツ	私鉄
チカテツ	地下鉄
テツ	鉄
テツドウ	鉄道
ヒキシメル	引き締める
ハオリ	羽織
ヨセル	寄せる
チンレツ	陳列
キフ	寄付
トシヨリ	年寄り
カタイ	堅い
メイチョ	名著
リエキ	利益
モチコム	持ち込む
オイコム	追い込む
イソガシイ	忙しい
ミコミ	見込み
モウシコミ	申し込み
カオ	顔
キョウツウゴ	共通語
ソボク	素朴
カンダイ	寛大
キンキュウ	緊急
キンチョウ	緊張
サンミャク	山脈
ドウミャク	動脈
マナコ	眼
ミハル	見張る
シュルイ	種類
ショルイ	書類
シンルイ	親類
ジンルイ	人類
イタマシイ	痛ましい
イクジ	育児
ツクル	造る
キヨラカ	清らか
カネテ	予て
ヨチ	余地
ミカギル	見限る
キンシ	禁止
フウトウ	封筒
ミナライ	見習い
シルシ	印
インショウ	印象
ヘダテル	隔てる
ケンキョ	謙虚
チョウイン	調印
ケシイン	消印
トル	採る
ムカイ	向かい
ギャク	逆
オウコク	王国
オウジ	王子
オウジャ	王者
オウジョ	王女
キュウショ	急所
キョウシュク	恐縮
ジョオウ	女王
フンマツ	粉末
イチガイニ	一概に
ヘンサイ	返済
ヘンジ	返事
ヘントウ	返答
メザメル	目覚める
メザマシドケイ	目覚まし時計
ヒョウゴ	標語
ヒョウジュン	標準
カンポウヤク	漢方薬
コウカン	交換
コウミョウ	巧妙
ジュウゾク	従属
ヘンカン	変換
ノリカエ	乗り換え
メモリ	目盛り
ヒサシブリ	久しぶり
セイヨウジン	西洋人
ヨウマ	洋間
ヨウサイ	洋裁
タンカ	短歌
タンキ	短期
タンダイ	短大
ゲンユ	原油
セキユ	石油
アブラ	油
ユデン	油田
ニッキュウ	日給
ツマ	妻
テツダウ	手伝う
フサイ	夫妻
カワル	代わる
タダヨウ	漂う
ボウドウ	暴動
ボウリョク	暴力
ジカンワリ	時間割
ヒキウケル	引受ける
ヒトエ	一重
センリョウ	占領
ドクセン	独占
カイシメル	買い占める
センゲン	宣言
センデン	宣伝
テキスル	適する
テオチ	手落ち
ヤサシイ	易しい
ザンコク	残酷
セイ	背
ハイケイ	背景
セナカ	背中
ショウワ	昭和
アブラ	脂
ニアウ	似合う
トリヨセル	取り寄せる
デンタク	電卓
ハイシ	廃止
モノズキ	物好き
イショク	移植
ヒキオコス	引き起す
ワリキル	割り切る
オキアガル	起き上がる
サクリャク	策略
ショウリャク	省略
ショクブツ	植物
ショクミンチ	植民地
リャクゴ	略語
マチナミ	町並
コウネツ	高熱
ジョウネツ	情熱
ネツ	熱
ネツイ	熱意
ネッキ	熱気
ネッシン	熱心
ハツネツ	発熱
ガッシュク	合宿
ヤド	宿
ヌカス	抜かす
イヤクヒン	医薬品
グウゼン	偶然
ザブトン	座布団
セイヤク	製薬
クスリ	薬
ヤクヒン	薬品
オソレ	恐れ
クズス	崩す
アシアト	足跡
ソウナン	遭難
アクヨウ	悪用
キゲン	紀元
セイサン	清算
タンキュウ	探究
アリガタイ	有り難い
アマス	余す
シリアイ	知合い
エンシュウ	演習
ガクシュウ	学習
トウヒ	逃避
カブル	被る
キケン	危険
ケンアク	険悪
ホケン	保険
ユルム	緩む
クウシャ	空車
ヤメル	辞める
シンライ	信頼
タノム	頼む
カクリョウ	閣僚
カンリョウ	官僚
カンカク	感覚
ゲンゴウ	元号
ジカク	自覚
ハッカク	発覚
ボウチョウ	傍聴
エンポウ	遠方
ジャマ	邪魔
サカリ	盛り
サカン	盛ん
ダン	壇
ホソウ	舗装
ヒキカエ	引換え
ケッショウ	結晶
センチョウ	船長
ゾウセン	造船
フネ	船
ウンパン	運搬
シタテル	仕立てる
バイ	倍
バイリツ	倍率
ナニブン	何分
ニル	煮る
モノサシ	物指
モノサシ	物指し
ヘイキン	平均
ミガル	身軽
サカサ	倒さ
スミ	墨
アソブ	遊ぶ
マルメル	丸める
ゼント	前途
マヨウ	迷う
ヨウト	用途
トチュウ	途中
アツリョク	圧力
キアツ	気圧
スエル	据える
タス	足す
オノオノ	各各
ソレゾレ	各各
ヒキガネ	引金
ヒキツヅキ	引続き
ハナビラ	花弁
オヨビ	及び
ゲイジュツ	芸術
ゲイノウ	芸能
コウゲイ	工芸
ハクアイ	博愛
ブンゲイ	文芸
ショクチュウドク	食中毒
ユルス	許す
キョカ	許可
トッキョ	特許
ウチケス	打消す
テンノウ	天皇
コス	超す
ミウシナウ	見失う
リンジ	臨時
トウカ	等価
ヒョウシ	拍子
エキ	駅
エキマエ	駅前
カミノケ	髪の毛
エンカイ	宴会
ショメイ	署名
ヌケダス	抜け出す
シメル	閉める
ハカイ	破壊
ムヨク	無欲
クイトメル	食止める
フサイ	負債
フクメン	覆面
ベンリ	便利
ツツミ	包み
ホウタイ	包帯
シカク	四角
トブ	飛ぶ
ノビ	伸び
ハナヨメ	花嫁
アブナイ	危ない
ザイリュウ	在留
カネ	鐘
ヨシュウ	予習
カラム	絡む
リュウガク	留学
リュウガクセイ	留学生
ツミ	罪
ムザイ	無罪
ユウザイ	有罪
ヨゴレル	汚れる
ヨワマル	弱まる
ヨワメル	弱める
チョウテイ	調停
テイシ	停止
フウリュウ	風流
ムガイ	無害
キョウミ	興味
シンコウ	振興
シンコウ	新興
ヘンキャク	返却
ゲンバク	原爆
チンボツ	沈没
バクゲキ	爆撃
バクハツ	爆発
ナイマク	内幕
ウチマク	内幕
キワマル	極まる
トタン	途端
ジョウリク	上陸
タイリク	大陸
チャクリク	着陸
リク	陸
リクグン	陸軍
リクジョウ	陸上
タマ	玉
オリカエシ	折り返し
ハイゾク	配属
メダマ	目玉
ウラドオリ	裏通り
ミナモト	源
シゲン	資源
ヨウシキ	洋式
ギシキ	儀式
ドロボウ	泥棒
テイセイ	訂正
デンパ	電波
ナミ	波
フクシャ	複写
マンジョウ	満場
ソウサク	創作
ソウゾウ	創造
ソウリツ	創立
ワカラズヤ	分からず屋
コショウ	故障
ワタシタチ	私たち
ショウガイ	障害
ケイゾク	継続
ウケツグ	受け継ぐ
チュウケイ	中継
ヒカゲ	日陰
スジ	筋
アトガキ	後書
カサ	傘
ネライ	狙い
イッタイ	一帯
セタイ	世帯
チタイ	地帯
ネッタイ	熱帯
フジョ	婦女
ナフダ	名札
レンタイ	連帯
エンキ	延期
エンチョウ	延長
ノゾム	臨む
リンジュウ	臨終
チカヨル	近寄る
コゲル	焦げる
ハネ	羽
ツトメル	努める
ジュンカン	循環
ドリョク	努力
キヨウ	器用
カタメル	固める
コテイ	固定
コユウ	固有
マンビキ	万引
ヒエコム	冷え込む
セントウ	戦闘
トウソウ	闘争
ニッソ	日ソ
ノットル	乗っ取る
ノリダス	乗り出す
セイシン	精神
ドウレツ	同列
ヘイレツ	並列
キソク	規則
ゲンソク	原則
コウソク	校則
ルイスイ	類推
カンパイ	乾杯
カイ	会
フナビン	船便
キガエ	着替え
キカエル	着替える
キガエル	着替える
ヒトリデ	一人で
ジン	人
ヒト	人
ニン	人
テツボウ	鉄棒
トウユ	灯油
ハンラン	反乱
ハラン	波乱
ヒナン	避難
オオキサ	大きさ
タイシタ	大した
タイシテ	大して
ダッセン	脱線
フキュウ	普及
フダン	普段
フツウ	普通
フダンギ	普段着
カラクチ	辛口
カイサン	解散
サンポ	散歩
シカイ	司会
シホウ	司法
ジョウシ	上司
ニジュウ	二十
ハタチ	二十
フツカ	二日
ハツカ	二十日
エンピツ	鉛筆
ケンコウ	健康
コモジ	小文字
イチニチジュウ	一日中
イチネンジュウ	一年中
カンソク	観測
ソクテイ	測定
ニクショク	肉食
キガン	祈願
ユタカ	豊か
ホウフ	豊富
ヤガク	夜学
カイヨウ	海洋
セイヨウ	西洋
トウヨウ	東洋
ネル	練る
オンワ	温和
ミッカ	三日
シズカ	静か
レイセイ	冷静
カイゼン	改善
カルイ	軽い
シンゼン	親善
ゼン	善
タチサル	立ち去る
トキニハ	時には
マチアワセ	待ち合わせ
タイホ	逮捕
アム	編む
ケッコン	結婚
シッケ	湿気
テイキュウビ	定休日
リコン	離婚
アツサ	厚さ
コウセイ	厚生
キゲキ	喜劇
チカヅク	近づく
オノズカラ	自ずから
フンシツ	紛失
ハタチ	二十歳
ヨロコビ	喜び
コウレイ	高齢
タイシャク	貸借
ヨソユキ	よそ行き
ネンレイ	年齢
ネッコ	根っ子
カコム	囲む
シキュウ	至急
シュウイ	周囲
セオウ	背負う
ヒキシマル	引き締まる
コス	越す
ミイダス	見出す
アズキ	小豆
ソツギョウ	卒業
ヨソミ	よそ見
ミナス	見なす
ミルミル	見る見る
ツキ	月
カエリミル	省みる
トウブン	等分
セマル	迫る
ハクリョク	迫力
フミキリ	踏切り
マモナク	間も無く
ツキナミ	月並み
ヨウレイ	用例
レイブン	例文
ショウニン	承認
タボウ	多忙
ニュウシツ	入室
ミカイ	未開
オジ	叔父
カタイ	硬い
オモワク	思惑
ゼン	前
マエ	前
テイシュ	亭主
メグスリ	目薬
クスリユビ	薬指
フタリマエ	二人前
ハナビラ	花びら
ハリダス	張り出す
ハリキル	張り切る
クズレル	崩れる
ホウカイ	崩壊
チョウホンニン	張本人
カエス	帰す
テジュン	手順
ジュン	順
ジュンイ	順位
ジュンチョウ	順調
ツグナウ	償う
ナマ	生
ハエル	生える
ショウズル	生ずる
ウマレル	生まれる
ソナワル	具わる
ウマレ	生まれ
カヨウキョク	歌謡曲
セイキ	世紀
チョッカク	直角
ツレテイク	連れて行く
イツカ	五日
ジシュウ	自習
チョウシュウ	聴衆
フクシュウ	復習
ダッシュツ	脱出
ダツゼイ	脱税
ダッタイ	脱退
コノアイダ	この間
ヨワネ	弱音
ハッサン	発散
タビ	旅
リョカン	旅館
リョカク	旅客
リョコウ	旅行
ゼッコウ	絶好
ゼッタイ	絶対
ゼツボウ	絶望
ナゲキ	嘆き
チュウゼツ	中絶
イリグチ	入口
ソノウエ	その上
カイキュウ	階級
コウキュウ	高級
ノボセル	上せる
ジョウキュウ	上級
チュウキュウ	中級
ドウキュウセイ	同級生
メザマシ	目覚まし
ケンビキョウ	顕微鏡
ツイキュウ	追究
フコウ	不幸
レイタン	冷淡
シアワセ	幸せ
イワ	岩
ヒメル	秘める
コバム	拒む
キョゼツ	拒絶
モノ	者
ヨウショ	洋書
レンシュウ	練習
オス	押す
フル	振る
ヨウダイ	容体
オサエル	押さえる
シズマル	静まる
キガル	気軽
テガル	手軽
マスイ	麻酔
ツタウ	伝う
タオレル	倒れる
トウサン	倒産
フリョ	不慮
メンドウ	面倒
マニアワセ	間に合わせ
マニアワセ	間に合せ
ザンショ	残暑
イチ	市
シュウリョウ	終了
リョウカイ	了解
サガシマワル	捜し回る
リョウショウ	了承
オクサマ	奥様
カンチョウ	官庁
ケイシチョウ	警視庁
ケンチョウ	県庁
セイホウケイ	正方形
チョウ	庁
コクモツ	穀物
ハクブツカン	博物館
キチョウヒン	貴重品
ミオトス	見落とす
シロ	城
モメン	木綿
オトシモノ	落とし物
タットイ	貴い
トウトイ	貴い
ヤリカタ	やり方
カンジャ	患者
イキカタ	生き方
チカヅク	近付く
ヨッカ	四日
ハレル	晴れる
キリ	霧
シメキリ	締め切り
トリシマリ	取り締まり
ミツケル	見付ける
トリシマリヤク	取締役
ヒキシメ	引き締め
キントウ	均等
コウトウ	高等
ニル	似る
センタクキ	洗濯機
タイトウ	対等
フミキル	踏み切る
フクジュウ	服従
ビョウドウ	平等
アクジュンカン	悪循環
キュウエン	救援
キュウキュウシャ	救急車
キュウサイ	救済
キュウジョ	救助
イマニモ	今にも
イマゴロ	今ごろ
タダイマ	ただ今
マジル	混じる
シッコウ	執行
ウケタマワル	承る
モウシコム	申し込む
タテマエ	建て前
トビコム	飛び込む
イッソウ	一層
コウソウ	高層
サイナン	災難
シン	新
チョッカン	直観
シュッパン	出版
シュッパンシャ	出版社
ノリバ	乗場
カンコンソウサイ	冠婚葬祭
カネモウケ	金もうけ
ロウゴ	老後
ロウジン	老人
マザル	交ざる
イン	員
ケツジョ	欠如
メイレイ	命令
カクド	角度
ココノカ	九日
ドウゾウ	銅像
サンカクケイ	三角形
タカク	多角
コトナル	異なる
ニゲダス	逃げ出す
ヒノイリ	日の入り
イレル	入れる
レンラク	連絡
ココロガケ	心がけ
ソン	損
ソンガイ	損害
ソンシツ	損失
トウテイ	到底
ハソン	破損
ヨリワケル	選り分ける
ヨル	選る
ニョウボウ	女房
テイリュウジョ	停留所
テイボウ	堤防
フサ	房
タテル	立てる
ロウヒ	浪費
オウボ	応募
オコス	興す
ボシュウ	募集
ナマリ	鉛
キョク	曲
サッキョク	作曲
クツシタ	靴下
テッカイ	撤回
イエ	否
イナ	否
イイエ	否
トオザカル	遠ざかる
ココロボソイ	心細い
イナズマ	稲妻
シハラウ	支払う
ダイガクセイ	大学生
シハライ	支払い
ハライ	払い
ケズル	削る
サクゲン	削減
ザツ	雑
ケモノ	獣
ケダモノ	獣
シバル	縛る
コムギコ	小麦粉
ミッセツ	密接
ミツユ	密輸
カテイ	家庭
ニワ	庭
ベンギ	便宜
カワルガワル	代わる代わる
オカワリ	お代わり
ハイイロ	灰色
アケル	明ける
セイト	生徒
トホ	徒歩
アクル	明くる
アクルヒ	明くる日
ヒキズル	引ずる
ワリダス	割出す
ジツ	実
ソチ	措置
ワリ	割
ワリビキ	割り引き
ワリビキ	割引き
ワリビキ	割り引
ネガウ	願う
クイチガウ	食違う
ブッキョウ	仏教
ギョウセキ	業績
ジッセキ	実績
キズツケル	傷付ける
セイセキ	成績
カラダ	身体
シンタイ	身体
ヤケド	火傷
カカワル	関わる
カンカツ	管轄
ケンチク	建築
シンチク	新築
カモツ	貨物
ガイカ	外貨
コドモ	子ども
オモイツキ	思い付き
ツウカ	通貨
ヒヅケ	日付け
ヒャッカテン	百貨店
ウケツケ	受付
ヨビカケル	呼びかける
ココロザシ	志
ウナガス	促す
ウゴク	動く
ヤヤモスレバ	動もすれば
ドウシ	同志
コンラン	混乱
ツツシム	慎む
ゼン	全
マッタク	全く
ネッチュウ	熱中
スベテ	全て
ショウシン	昇進
ジョウショウ	上昇
メカタ	目方
ミタメ	見た目
ガンカ	眼科
フトル	太る
イケ	池
オサメル	修める
ツカマル	捕まる
アユム	歩む
トラワレル	捕らわれる
ワガ	我が
ワガクニ	我が国
ワレワレ	我々
キンム	勤務
キンロウ	勤労
ツウキン	通勤
トウキ	陶器
タメ	為
ホカニ	外に
コウイ	行為
ツツ	筒
ケツアツ	血圧
ケッカン	血管
ミマモル	見守る
シュッケツ	出血
イイアラワス	言い表す
イイアラワス	言い表わす
ワカイ	若い
チヂム	縮む
ダイノウ	大脳
ヨクセイ	抑制
オサエル	抑える
カオル	香る
チヂミ	縮み
セシ	セ氏
カイマク	開幕
マゲル	曲げる
シッソ	質素
キワメル	極める
キメル	極める
メザマシイ	目覚ましい
キョジュウ	居住
ダイメイシ	代名詞
リガクブ	理学部
カイ	貝
カンセン	感染
センショク	染色
ウラガエス	裏返す
オンド	温度
キオン	気温
カゴウ	化合
ザツオン	雑音
ザツダン	雑談
テブリ	手振り
トウエイ	投影
イツノマニカ	何時の間にか
ショウタイ	招待
アゲル	揚げる
アテハマル	当てはまる
アテハメル	当てはめる
ホントウニ	本当に
シキ	四季
ヨウカ	八日
ヤッツ	八つ
ナツカシイ	懐かしい
ワリアテル	割当てる
コンナン	困難
ネギル	値切る
ムイカ	六日
ムッツ	六つ
アシモト	足下
エイセイ	衛星
ホシ	星
カタナ	刀
ケイショウ	軽傷
ゴシュジン	ご主人
ショウガイ	傷害
タイコ	太鼓
ジュウショウ	重傷
キズ	傷
ウチケシ	打消し
トリケシ	取消し
ビンボウ	貧乏
イロイロ	色々
ブラサガル	ぶら下がる
ブラサゲル	ぶら下げる
センタク	選択
オモイツク	思い付く
オロス	下ろす
ガイトウ	該当
ココロザス	志す
ユウシュウ	優秀
チョシャ	著者
チョショ	著書
チョメイ	著名
オカス	犯す
ムエキ	無益
ショウチョウ	象徴
トクチョウ	特徴
ニンタイ	忍耐
ホウ	法
カタマリ	固まり
ホウガクブ	法学部
アトカタヅケ	後片付け
ザッシ	雑誌
ハタケ	畑
ゴウバン	合板
ゴウハン	合板
フイニ	不意に
ヤッテクル	やって来る
キンコ	金庫
サッスル	察する
ムス	蒸す
スイジョウキ	水蒸気
ブンコ	文庫
レイゾウコ	冷蔵庫
デカケル	出掛ける
ツレテクル	連れて来る
アラワレ	表れ
ダンアツ	弾圧
バクダン	爆弾
オソルオソル	恐る恐る
コウフク	降伏
セイ	性
ホショウ	補償
ワルイ	悪い
マチカド	町角
カンコウ	刊行
ゲッカン	月刊
シュウカン	週刊
ジュウジカ	十字架
ソウカン	創刊
チョウカン	朝刊
テキ	的
マト	的
フウリン	風鈴
エイゾウ	映像
ガゾウ	画像
カワギシ	川岸
ソウゾウ	想像
セイコウ	成功
ユウヤケ	夕焼け
ヨウ	用
カレイ	華麗
コンキョ	根拠
ショウコ	証拠
カオリ	香り
ヒキカエス	引き返す
ヨコモジ	横文字
ケッセキ	欠席
イキカエル	生き返る
タビ	度
ナベ	鍋
フカケツ	不可欠
カエル	返る
イチドニ	一度に
シンジュ	真珠
ヘンコウ	変更
トオイ	遠い
シイテ	強いて
シンピ	神秘
ソマル	染まる
デンセン	伝染
ヒショ	秘書
ヒミツ	秘密
カエル	換える
イッキニ	一気に
キママ	気まま
キョヒ	拒否
オキニイリ	お気に入り
オジギ	お辞儀
ケイ	刑
ケイジ	刑事
ケイムショ	刑務所
シケイ	死刑
サカ	坂
コヨミ	暦
ナノカ	七日
ジコク	時刻
シンコク	深刻
ジュウダイ	十代
カイテイ	海底
シンガッキ	新学期
マチハズレ	町外れ
ソコ	底
ヒキツグ	引継ぐ
オオヤケ	公
サンセイ	賛成
サンピ	賛否
ノウコウ	農耕
ムソウ	夢想
ヤキトリ	焼き鳥
カンソウ	乾燥
モテル	持てる
モテナス	持て成す
イッチ	一致
リンカク	輪郭
オチツク	落ち着く
コウサン	降参
ヘビ	蛇
カカエル	抱える
ヤリトリ	やり取り
サル	猿
クリカエス	繰り返す
トリシマル	取り締まる
トリイレル	取り入れる
トレル	取れる
チリトリ	ちり取り
チリトリ	ちり取
チョウトッキュウ	超特急
トシトッタ	年取った
セイフク	制服
セメル	責める
フフク	不服
フク	服
フクソウ	服装
トシガス	都市ガス
マゼル	混ぜる
ハンコウ	犯行
ハンザイ	犯罪
ハンニン	犯人
コウヤ	荒野
アレノ	荒野
コン	紺
ボウフウウ	暴風雨
チョウコウ	徴候
トル	執る
モッテ	以て
シタガウ	従う
ヤドヤ	宿屋
チャク	着
ジェットキ	ジェット機
サイフ	財布
ココロガケ	心掛け
ヌノ	布
フトン	布団
オソロシイ	恐ろしい
タイラ	平ら
オイル	老いる
コウリテン	小売り店
テラ	寺
ジイン	寺院
ソウ	総
シタ	舌
フルマウ	振る舞う
キバン	基盤
ナラウ	習う
イレバ	入れ歯
オモイトドマル	思いとどまる
オモイアタル	思い当たる
ムスコ	息子
リソク	利息
ソコナウ	損う
コウモク	項目
ツクリバナシ	作り話
ナガバナシ	長話
モモ	桃
タツ	絶つ
サメル	覚める
アノヨ	あの世
ジュドウテキ	受動的
エイエン	永遠
マチマチ	区々
キョウヨウ	教養
ニガワライ	苦笑い
チュウコク	忠告
ヨウセイ	養成
リョウヨウ	療養
イッショウケンメイ	一生懸命
ケンショウ	懸賞
ケネン	懸念
ケン	県
シコウサクゴ	試行錯誤
ヒルサガリ	昼下がり
ガイトウ	街頭
シガイ	市街
ツヅク	続く
ツヅケル	続ける
ベンガク	勉学
キョダイ	巨大
ススメル	進める
トギレル	途切れる
ソウショク	草食
サンビ	賛美
シル	汁
ジシン	地震
ヒキツギ	引継ぎ
ヤスッポイ	安っぽい
ネガイ	願い
ネンガン	念願
カイガ	絵画
エホン	絵本
カキ	柿
ケッパク	潔白
キボウ	希望
キメツケル	決めつける
ヒキツケル	引付ける
クルシム	苦しむ
ケイヤク	契約
ニアイ	似合い
ショウスウ	小数
ブンスウ	分数
カカゲル	掲げる
ケイサイ	掲載
ヒッコム	引っ込む
カツヤク	活躍
ヒヤク	飛躍
キケン	棄権
ノボル	昇る
ゼンソクリョク	全速力
ホウキ	放棄
キガカリ	気掛かり
ユミ	弓
ハジメテ	初めて
セイレツ	整列
ホッスル	欲する
イヨク	意欲
ホシガル	欲しがる
ケイゴ	敬語
イケバナ	生花
イタミ	痛み
セッショク	接触
トラエル	捕える
カンテイ	官邸
サシノベル	差し伸べる
ヨブン	余分
ノバス	伸ばす
イゼン	依然
イライ	依頼
ニガス	逃がす
イッシンニ	一心に
コセキ	戸籍
コクセキ	国籍
ザイセキ	在籍
ショセキ	書籍
ヤキソバ	焼きそば
イキギレ	息切れ
テイサツ	偵察
オショク	汚職
オセン	汚染
サカダチ	逆立ち
ヨゴレ	汚れ
グンシュク	軍縮
ササエル	支える
シュクショウ	縮小
タンシュク	短縮
フットウ	沸騰
カンゲン	還元
マガリカド	曲がりかど
ダイイチ	第一
ヘンカン	返還
カイスイヨク	海水浴
カマ	釜
バクゼン	漠然
キンゾク	金属
ユウ	結う
ショゾク	所属
フゾク	付属
オゴソカ	厳か
ワライ	笑い
エガオ	笑顔
タイオンケイ	体温計
カテイ	仮定
タガイ	互い
タガイニ	互いに
ソウゴ	相互
セイレキ	西暦
ツク	点く
フクゴウ	複合
フクザツ	複雑
フクスウ	複数
トモス	点す
キリストキョウ	キリスト教
ハイリョ	配慮
イスラムキョウ	イスラム教
ユウビンキョク	郵便局
ユウビン	郵便
スマセル	済ませる
ツケル	漬ける
ドウフウ	同封
ムチュウ	夢中
ヤクソク	約束
ワゴム	輪ゴム
スマナイ	済まない
カキトル	書き取る
カク	書く
マエガキ	前書き
ナカ	仲
チュウカイ	仲介
ナカマ	仲間
リレキショ	履歴書
カキゾメ	書き初め
カキトリ	書き取り
カキトリ	書取
エイヨウ	栄養
スイチョク	垂直
カス	貸す
ネッコ	根っこ
ニュウサツ	入札
イキワタル	行渡る
ハラ	原
ユウエツカン	優越感
ワク	枠
サキ	先
カチク	家畜
ドモ	共
トモ	共
キョウワコク	共和国
ユウカン	夕刊
ユウショク	夕食
ユウガタ	夕方
トモドモ	共々
ゲネツ	解熱
シグレ	時雨
チエ	知恵
キジュン	規準
トクスル	得する
カタサ	固さ
コウカ	硬化
コクバン	黒板
イタ	板
ヘイコウ	閉口
ワカル	解る
ケイレツ	系列
ノリマワス	乗回す
レツ	列
レッシャ	列車
レットウ	列島
シャコウテキ	社交的
セイフク	征服
テラス	照らす
テル	照る
サワル	触る
マエブレ	前触れ
テヅクリ	手造り
ギキョク	戯曲
キヨイ	清い
アラカジメ	予め
ハナス	離す
トビオリル	飛び下りる
イッコウ	一向
ムク	向く
ムケ	向け
ムケル	向ける
シャッキン	借金
アカンボウ	赤ん坊
ナイコウテキ	内向的
キタナイ	汚い
ユルヤカ	緩やか
カンワ	緩和
タノモシイ	頼もしい
キセツ	季節
セツ	節
フシ	節
サマス	覚ます
ジュヨウ	需要
シュッケツ	出欠
スバヤイ	素早い
ウズマル	埋まる
ウマル	埋まる
ホネ	骨
ジシャク	磁石
テッコツ	鉄骨
ミネ	峰
メンツ	面子
ユダネル	委ねる
チュウシャ	注射
ハト	鳩
ホウシャノウ	放射能
トトノウ	調う
カル	刈る
ケイコウ	傾向
ワンリョク	腕力
ソマツ	粗末
トドケ	届
キンセイ	均整
キンヨウ	金曜
ゲツヨウ	月曜
スイヨウ	水曜
ドヨウ	土曜
ニチヨウ	日曜
ヨウビ	曜日
オク	億
オオヤ	大屋
ハンニチ	反日
ハンメン	反面
アソビ	遊び
アミモノ	編物
モトヨリ	元より
オチュウゲン	お中元
コンメイ	混迷
メイワク	迷惑
ジカンワリ	時間割り
オモタイ	重たい
オモンズル	重んずる
ユメ	夢
マキコム	巻き込む
チカク	近く
キンジツ	近日
ブッソウ	物騒
コウニュウ	購入
ブンボ	分母
フヘン	普遍
シキ	指揮
ハン	判
ハンコ	判子
トリワケ	取り分
ワカル	判る
ヨル	寄る
ネンリョウ	燃料
ジュウジツ	充実
テンカ	点火
モノサシ	物差
アメ	雨
ノリコム	乗り込む
コム	込む
サンコウショ	参考書
ニンジン	人参
ヘイテン	閉店
イッショ	一緒
トマドウ	戸惑う
ウレル	売れる
ウリアゲ	売上げ
イセキ	遺跡
ゲッシャ	月謝
アヤマル	謝る
アト	跡
キク	利く
クミアワセル	組み合わせる
フモウ	不毛
ショウベン	小便
オキアイ	沖合い
クミアワセ	組み合わせ
クミアワセ	組合せ
クミアワセ	組合わせ
ヒキハナス	引離す
ケンエツ	検閲
シラセ	知らせ
シラセル	知らせる
シレル	知れる
チュウシャジョウ	駐車場
デントウ	電灯
トウダイ	灯台
アリガタイ	有難い
ヨダン	余談
カモク	課目
タンケン	探険
シラズシラズ	知らず知らず
ヒトゴロシ	人殺し
ニゲミチ	逃げ道
シャショウ	車掌
チョウ	腸
ハミガキ	歯磨き
ヨワミ	弱み
タエル	絶える
キョクタン	極端
トリカエス	取り返す
センタン	先端
タイショウ	対称
ミチバタ	道端
ホッタン	発端
アラシ	嵐
ハシ	端
ウンチン	運賃
ヤチン	家賃
マドギワ	窓際
チンギン	賃金
オリ	折
トキオリ	時折
トウシャ	投射
ショウカイ	紹介
カクトク	獲得
アオジロイ	青白い
ブタ	豚
ベツ	別
トリモドス	取り戻す
フユヤスミ	冬休み
モノ	物
アンキ	暗記
ソノモノ	その物
エンキョリ	遠距離
キヌ	絹
ガッペイ	合併
ムコウガワ	向こう側
クサ	草
マカセル	任せる
ヒク	引く
テッテイ	徹底
フチョウ	府庁
クラ	蔵
ヒキツル	引きつる
スンポウ	寸法
ノミモノ	飲み物
マグレ	紛れ
キチョウ	貴重
モトメル	求める
トコロ	所
ヒトムカシ	一昔
トジマリ	戸締まり
ツギ	次
ジジョ	次女
ショウゲキ	衝撃
ショウトツ	衝突
シマル	締まる
アブク	泡
ツギツギニ	次々に
サイソク	催促
ショウテン	焦点
ヒトシイ	等しい
シオミズ	塩水
ウエル	植える
ウバウ	奪う
ヒトナミ	人並み
アマド	雨戸
カイコ	解雇
コヨウ	雇用
ヤクス	訳す
カサイ	火災
ワザワイ	災い
サイガイ	災害
センサイ	戦災
チッソク	窒息
ボウサイ	防災
ヒンキャク	賓客
アクリョク	握力
フエ	笛
ヒャクショウ	百姓
クラシ	暮らし
クレ	暮れ
カワセ	為替
ダイタイ	代替
オキアイ	沖合
ブンセキ	分析
ミダス	乱す
キンシュ	禁酒
ヨキン	預金
スキキライ	好き嫌い
ダイキライ	大嫌い
フキゲン	不機嫌
カカワル	係わる
カンカ	感化
カンイ	簡易
カンタン	簡単
チラシ	散らし
チラシ	散らし
チラバル	散らばる
ケイハク	軽薄
ジョウホ	譲歩
ウスメル	薄める
メイショウ	名称
キンニク	筋肉
コタエ	答
ニク	肉
ニクシン	肉親
オオモリ	大盛り
ノウゼイ	納税
ナットク	納得
ツワモノ	強者
ナニユエ	何故
ナゼ	何故
イマシメ	戒め
ジュモク	樹木
ハライコム	払い込む
イショクジュウ	衣食住
ミブリ	身振り
チョウセン	挑戦
ホウモツ	宝物
タカラモノ	宝物
ウチアワセ	打ち合わせ
ウチアワセ	打ち合せ
ウチアワセ	打合せ
ウチアワセ	打合わせ
ウチアワセル	打ち合わせる
サッカク	錯覚
ショウ	章
ビョウ	秒
ブンショウ	文章
シンゾウ	心臓
オシム	惜しむ
カラ	殻
ホウリツ	法律
カッコク	各国
カクチ	各地
テアライ	手洗い
スイセン	水洗
センメン	洗面
センメンジョ	洗面所
サソウ	誘う
ユウドウ	誘導
ユウワク	誘惑
ノム	飲む
ニイサン	兄さん
ハジメニ	始めに
ウルオイ	潤い
フンソウ	紛争
サカエル	栄える
ハエル	栄える
チンタイ	賃貸
バッスル	罰する
カシダシ	貸し出し
タットブ	貴ぶ
トウトブ	貴ぶ
ジキニ	直に
ジカニ	直に
オレ	俺
ヒョウサツ	表札
ヤリナオシ	やり直し
ヤリナオス	やり直す
ジメツ	自滅
シュウキョウ	宗教
メツボウ	滅亡
ゴクロウサマ	ご苦労さま
ヨリミチ	寄り道
ニセル	似せる
ソクシン	促進
コウハン	甲板
カンパン	甲板
シンチョウ	慎重
ヒカエル	控える
コウソ	控訴
オモイコム	思い込む
ツケコム	付け込む
ニワトリ	鶏
シキ	式
トオカ	１０日
オクル	贈る
ワシキ	和式
ヒッカカル	引っ掛かる
チョクレツ	直列
フナレ	不慣れ
イチイチ	一一
ヒビキ	響き
ニギル	握る
キャクショク	脚色
ドウルイ	同類
ヒグレ	日暮れ
サンショウ	参照
ショウメイ	照明
ボンチ	盆地
ヒキカエ	引き替え
ヒキカエ	引替え
ミチジュン	道順
ウチュウ	宇宙
サケ	酒
トドメル	留める
ヌグ	脱ぐ
イッキョニ	一挙に
ユルイ	緩い
キンセン	金銭
ゾウオ	憎悪
キゼツ	気絶
ウエル	飢える
シュクデン	祝電
ウスイ	薄い
ヨクソウ	浴槽
マガリカド	曲がり角
イイカエス	言い返す
コウドウ	講堂
ショクドウ	食堂
イイカゲン	いい加減
リッキョウ	陸橋
シミ	染み
グチ	愚痴
ヤシナウ	養う
サキホド	先程
タンキ	短気
ヒカン	悲観
ヒゲキ	悲劇
カナシミ	悲しみ
テガラ	手柄
ヒッシニ	必死に
テゴタエ	手応え
ソウサ	操作
タイソウ	体操
ケイタイ	携帯
テイケイ	提携
メイシン	迷信
オク	奥
カイボウ	解剖
コクデン	国電
ツケモノ	漬物
ジュンジョウ	純情
シンダン	診断
シンリョウ	診療
カシダス	貸し出す
カイモノ	買物
スマイ	住まい
セキハン	赤飯
サツエイ	撮影
ジョウトウ	上等
トクソク	督促
ノウドウテキ	能動的
ハンジョウ	繁盛
タンジョウ	誕生
ナクス	無くす
ナクナル	無くなる
ムキブツ	無機物
ムセイブツ	無生物
サイ	再
サライゲツ	再来月
シンリャク	侵略
クライ	位
ケッサク	傑作
アワテル	慌てる
ナガメル	眺める
カケル	掛ける
ウラミ	恨み
オク	置く
ブショウ	無精
カンシャ	感謝
タクラミ	企み
キュウコウ	休講
シャザイ	謝罪
ロウニャク	老若
ロウジャク	老若
スウ	吸う
シン	真
フヨウ	扶養
マッスグ	真っ直ぐ
リュウ	流
ハヤル	流行る
サガシマワル	探し回る
ミナラウ	見習う
サス	刺す
トマル	留まる
ハイシャ	歯医者
メイシ	名刺
シゲキ	刺激
ココロガケル	心がける
トウチャク	到着
トウライ	到来
ミチノリ	道のり
ニュウセキ	入籍
アリアワセ	有り合わせ
アリアワセ	有り合せ
ソヨカゼ	そよ風
イツノマニカ	いつの間にか
マモナク	間もなく
チラカル	散らかる
ツカノマ	つかの間
ダレ	誰
クチゴモル	口ごもる
クチグチニ	口々に
ウスマル	薄まる
クチゲンカ	口げんか
トウメイ	透明
フトウメイ	不透明
テヌグイ	手ぬぐい
ヤリスゴス	やり過ごす
ツナミ	津波
メグル	巡る
スコシモ	少しも
オル	折る
カベ	壁
イネ	稲
ハナレル	放れる
カリニ	仮に
カナシイ	悲しい
アンサツ	暗殺
ハチ	鉢
コクイッコク	刻一刻
アヤツル	操る
トウゲ	峠
ブンレツ	分裂
キリステル	切り捨てる
タズサエル	携える
ビンカン	敏感
レイゾウ	冷蔵
オクユキ	奥行
トリ	鳥
トリイ	鳥居
チョット	一寸
タンジュン	単純
ゼセイ	是正
リョウ	料
ミツメル	見詰める
メシ	飯
サバク	裁く
タツ	裁つ
ハイジョ	排除
ハイスイ	排水
ジョウ	状
ミヨリ	身寄り
ユウフク	裕福
ヨユウ	余裕
チュウケン	中堅
コウガクブ	工学部
タテル	建てる
ツウヤク	通訳
バイタイ	媒体
ウリコム	売り込む
ウキ	雨季
ヒカエシツ	控え室
ワリコム	割り込む
カオダチ	顔立ち
ゴウトウ	強盗
センリツ	旋律
ヌスム	盗む
ワゴ	和語
オクリモノ	贈物
シバイ	芝居
オサナナジミ	幼なじみ
プロヤキュウ	プロ野球
ヨコヅナ	横綱
カヘイ	貨幣
ジエイギョウ	自営業
アケル	空ける
スイコム	吸い込む
キュウシュウ	吸収
ムナシイ	空しい
コキュウ	呼吸
ウエジニ	餓死
ガシ	餓死
エツラン	閲覧
コテン	古典
ノビル	伸びる
サグル	探る
テンケイ	典型
ジテン	辞典
ナス	為す
キュウクツ	窮屈
ワキ	脇
オミヤゲ	お土産
サットウ	殺到
ツユイリ	梅雨入り
トリアツカイ	取り扱い
サカラウ	逆らう
ニクシミ	憎しみ
コキャク	顧客
セカス	急かす
キュウヨウ	急用
ツクス	尽くす
オオイソギ	大急ぎ
ワカス	沸かす
ネガエリ	寝返り
カンゴ	看護
カンゴフ	看護婦
カンバン	看板
ヨス	止す
ヤム	止む
イキドマリ	行き止まり
ヒキトメル	引き止める
ヒキトメル	引止める
トメドナク	止めどなく
ソショウ	訴訟
ソウベツカイ	送別会
トモナウ	伴う
ケイカイ	警戒
ミノウ	未納
イイカエル	言い換える
フクシ	福祉
サンボン	三本
ブタニク	豚肉
メイヨ	名誉
アンジ	暗示
カンゲイ	歓迎
ドウジン	同人
カワイソウ	可哀相
カルハズミ	軽はずみ
キンベン	勤勉
カマエル	構える
チョウヤク	跳躍
ベンキョウ	勉強
ダイダイ	代々
エンソウ	演奏
ガクワリ	学割
ガクワリ	学割り
サク	割く
ワリビク	割り引く
ワリビク	割引く
ワレル	割れる
イキ	粋
キカザル	着飾る
ワリアイニ	割合に
ヤミ	闇
ガクフ	楽譜
チカヅケル	近づける
サワギ	騒ぎ
ソウオン	騒音
ソウドウ	騒動
マギレル	紛れる
キク	聞く
イタム	傷む
ミナゲ	身投げ
アイヅチ	相づち
ヨクジツ	翌日
ヨクネン	翌年
ゲシ	夏至
ジャグチ	蛇口
タイヨウ	太陽
ヨウ	陽
クッツケル	くっ付ける
ブツケル	打付ける
カラダツキ	体付き
オイコス	追い越す
ハバツ	派閥
ツケ	付け
ツケル	付ける
キヲツケル	気を付ける
コトヅケル	言付ける
ヒキノバス	引き延ばす
ヒッツク	引っ付く
ヤッツケル	やっ付ける
アラッポイ	荒っぽい
セツナイ	切ない
キレ	切れ
キレル	切れる
ウリキレ	売り切れ
ウリキレル	売り切れる
チギレル	千切れる
ヤリキレナイ	やり切れない
ユビキリ	指切り
コシツ	固執
ジゴ	事後
セツ	説
トク	説く
ダンペン	断片
シマル	閉まる
ハヤメル	速める
ジマエ	自前
ヨクバリ	欲張り
ヨビカケ	呼び掛け
ハミデル	食み出る
ハミダス	食み出す
セイゴ	生後
フジョ	扶助
ベンショウ	弁償
ミンセイ	民生
ユラグ	揺らぐ
ウミ	生み
シンケン	真剣
メンキョ	免許
レンコウ	連行
アリガトウ	有難う
ナンナク	難なく
ドウモアリガトウ	どうも有難う
キセイ	既成
イコイ	憩い
サシミ	刺身
ホル	掘る
トリアツカウ	取り扱う
スイセン	推薦
ソコネル	損ねる
タンサン	炭酸
チラス	散らす
トナリ	隣
タテヨコ	縦横
ジュウオウ	縦横
クノウ	苦悩
ナヤミ	悩み
スグレル	優れる
チュウカ	中華
ソレゾレ	夫れ夫れ
ハナヤカ	華やか
オンセン	温泉
コウブ	後部
ジョウブ	上部
イズミ	泉
ヨフカシ	夜更かし
イマシメル	戒める
ムラガル	群がる
ムレル	群れる
ボウギョ	防御
セイギョ	制御
ハンイ	範囲
ヨウシツ	洋室
ドレ	何れ
ドレドレ	何れ何れ
ナニゲナク	何気無く
ナニカト	何かと
イネムリ	居眠り
フユ	冬
トウキ	冬季
ドウチ	同地
ナントナク	何となく
ヘイ	塀
クチビル	唇
カワ	皮
スイガラ	吸い殻
ヒトアシ	一足
イッソク	一足
テツガク	哲学
ツケタス	付け足す
ホンギョウ	本業
アシアト	足あと
キチガイ	気違い
ギョギョウ	漁業
ギョセン	漁船
バチガイ	場違い
チガイナイ	違いない
ショウボウシャ	消防車
フンスイ	噴水
トウホウ	東方
コウバン	鋼板
コウハン	鋼板
カミガタ	上方
カイシャク	解釈
シャクホウ	釈放
カミワザ	神業
ジコ	自己
マネ	真似
バンメ	番目
カレル	枯れる
カレハ	枯れ葉
マワシ	回し
ジュツゴ	術語
ネドコ	寝床
チョキン	貯金
ハナシコム	話込む
ヒカエシツ	控室
メス	雌
ゼン	禅
ダキョウ	妥協
イセイ	威勢
イチジキン	一時金
ケンイ	権威
クラス	暮らす
テヅクリ	手作り
コクミンネンキン	国民年金
コウイン	行員
ゴウカ	豪華
ドナル	怒鳴る
ミチビク	導く
ワスレモノ	忘れ物
コヅツミ	小包み
ハドメ	歯止め
ソナエツケル	備え付ける
ビコウ	備考
ヨビコウ	予備校
オタク	お宅
イチダイ	一大
エンタイ	延滞
ジュウタイ	渋滞
タイザイ	滞在
テイタイ	停滞
マカナウ	賄う
オオサジ	大さじ
トマル	泊まる
ビショウ	微笑
タチ	立ち
リッポウメートル	立方メートル
タチアイ	立ち合い
カイギョウ	開業
ユズル	譲る
ゼッコウ	絶交
ハナシカケル	話しかける
シツレイ	失礼
チョウレイ	朝礼
スキトオル	透き通る
クウフク	空腹
ショウジョウ	症状
ダサンテキ	打算的
ニッコウヨク	日光浴
ヒキザン	引き算
ヒキザン	引算
ワリザン	割り算
ハイザラ	灰皿
ザンテイ	暫定
ハンシャテキ	反射的
スベル	滑る
クキ	茎
シャカイガク	社会学
ガク	学
ソウコ	倉庫
ランザツ	乱雑
オシウリ	押し売り
ミトドケル	見届ける
ヒトリデ	独りで
ヒキモドス	引き戻す
ヒル	昼
ヒトリデニ	独りでに
モドル	戻る
ヒルマ	昼間
チュウショク	昼食
ドクトク	独得
タカ	高
オチャ	お茶
アワセル	併せる
チャ	茶
カンゾウ	肝臓
カンジン	肝心
ソダテル	育てる
モッテイク	持っていく
ハシラ	柱
デンチュウ	電柱
ハグクム	育む
エンガン	沿岸
ハツコイ	初恋
ナゾ	謎
ゾイ	沿い
タクイツ	択一
ビミョウ	微妙
ミサキ	岬
ガッショウ	合唱
ドウギ	動議
コマ	独楽
モラス	漏らす
ツキナミ	月並
アライ	荒い
チュウキョウ	中京
トクメイ	匿名
ワカツ	分かつ
マツリ	祭り
ワカチ	分かち
カタマル	固まる
フクロ	袋
コイ	濃い
マン	万
モウシワケナイ	申し訳ない
キョウコウ	恐慌
ツク	着く
ツケル	着ける
サクイン	索引
ジョウズル	乗ずる
ソウサク	捜索
マエマエ	前々
ケッセン	決戦
マコトニ	誠に
セイイ	誠意
セイジツ	誠実
イタム	痛む
レンセン	連戦
ジッセン	実戦
ソナエル	具える
フレアウ	触れ合う
イキ	生き
ボウネンカイ	忘年会
オソウ	襲う
シュウゲキ	襲撃
ホウワ	飽和
サシミ	刺し身
ユキ	雪
ナダレ	雪崩
オモイツキ	思いつき
シッピツ	執筆
フデ	筆
ボウサン	坊さん
マンネンヒツ	万年筆
イイブン	言い分
リツ	率
サンザン	散々
キョウクン	教訓
クンレン	訓練
ヤマイ	病
ジョウジョウ	上々
アビル	浴びる
ヤキニク	焼肉
サンブ	三部
オサマル	納まる
ハイユウ	俳優
オサメル	納める
ジドウ	児童
ジッタイ	実体
オオゴエ	大声
ドウワ	童話
ツカレル	疲れる
サムライ	侍
タカラ	宝
トカス	溶かす
ミガラ	身柄
ヒトガラ	人柄
ゼンアク	善悪
ネンリキ	念力
ガラ	柄
チチュウ	地中
オドロキ	驚き
マヤク	麻薬
チカラダメシ	力試し
ジュウロク	十六
シャカイジギョウ	社会事業
ムネ	胸
ソウゾウシイ	騒々しい
アイタイ	相対
ムスメ	娘
カコウ	囲う
スナ	砂
ユウレイ	幽霊
チホウギカイ	地方議会
カブ	下部
ホロビル	滅びる
ミトレル	見とれる
アセル	焦る
イタワル	労る
シオ	塩
レイダイ	例題
アヤマリ	誤り
ゴカイ	誤解
ホウテイ	法定
シゼンニ	自然に
ウカブ	浮かぶ
カタヅケル	片付ける
フジョウ	不定
ヒッカケル	引っ掛ける
ガイライ	外来
サシカカル	差し掛かる
モハヤ	最早
ジョウナイ	場内
ココロガケル	心掛ける
ハヤク	早く
ハヤビケ	早引け
ハヤビキ	早引き
ネンライ	年来
ハヤバヤ	早々
ソウソウ	早々
シュミ	趣味
ケッカン	欠陥
ドウ	胴
ドウタイ	胴体
カエル	替える
トラワレル	捕われる
ショサイ	書斎
ヒトゴミ	人ごみ
ダイヒョウテキ	代表的
マアジャン	麻雀
マージャン	麻雀
ミノガス	見逃す
イチョウ	胃腸
ノリオクレル	乗り遅れる
オクレル	遅れる
ハナシカタ	話し方
イッテ	一手
ジュンジョ	順序
レイキン	礼金
レイフク	礼服
ジゼン	慈善
オトウト	弟
デシ	弟子
ゲジュン	下旬
ツヨミ	強み
ジョウジュン	上旬
チュウジュン	中旬
ガクナイ	学内
ウデ	腕
キアイ	気合
コクガク	国学
ニッシュツ	日出
オシモンドウ	押し問答
カキコトバ	書き言葉
ショウコク	小国
ハガキ	葉書
シュンカシュウトウ	春夏秋冬
フタナヌカ	二七日
シャダンキ	遮断機
オテツダイサン	お手伝いさん
シュシ	趣旨
ダイニン	代人
ツタエル	伝える
ヨウシ	要旨
シモキ	下期
コンキ	今期
カウ	飼う
ハタラク	働く
イチジキ	一時期
ニキ	二期
ガイヤ	外野
コウシャ	校舎
イナカ	田舎
オチアウ	落ち合う
オコナイ	行い
ギゾウ	偽造
シンギ	真偽
ギソウ	偽装
オウベイ	欧米
ヒカク	比較
ヒキシメル	引締める
トリマトメル	取りまとめる
アイテドル	相手取る
スキ	好き
サキホド	先ほど
スキズキ	好き好き
イチブ	一分
キョウワ	協和
ノケル	退ける
ドケル	退ける
イチジルシイ	著しい
ニブン	二分
ウメボシ	梅干し
タチノク	立ち退く
キザシ	兆し
ノク	退く
シリゾク	退く
ヒク	退く
ナゾラエル	準える
ジュンキュウ	準急
トコ	床
トコノマ	床の間
ゼンシャ	全社
フンガイ	憤慨
モウシコミ	申込み
モウシコミ	申込
ノーベルショウ	ノーベル賞
ナレ	慣れ
シュウカン	習慣
チヒョウ	地表
ニギリシメル	握り締める
クワシイ	詳しい
ショウサイ	詳細
センゴク	戦国
ミンセイ	民政
イクサ	戦
ドノヘン	どの辺
センチュウ	戦中
オチイル	陥る
ハゲム	励む
ソウムブ	総務部
エイキ	英気
カイツウ	開通
ミドリ	緑
カヨイ	通い
トオシ	通し
コウザン	高山
サンカン	山間
ソンチョウ	尊重
イル	要る
ヤマテ	山手
イシケッテイ	意思決定
テイコウ	抵抗
ムカイ	向い
キョウハク	脅迫
ジツギョウカ	実業家
ヨワル	弱る
イシアタマ	石頭
トウ	頭
アタマ	頭
カシラ	頭
イワイ	祝い
シュクジツ	祝日
チヂマル	縮まる
レイ	礼
フケル	更ける
シブイ	渋い
マド	窓
マドグチ	窓口
ゴト	毎
マイ	毎
ゲリ	下痢
ジュウドウ	柔道
ドウチョウ	同調
シキイ	敷居
ノリカエ	乗換え
ヤワラカイ	柔らかい
オイシャサン	お医者さん
ヒサシブリ	久し振り
ジュリョウ	受領
ソウリョウジ	総領事
キガネ	気兼ね
ハタ	旗
コッキ	国旗
ネムケ	眠気
キョリ	距離
ミアタル	見当たる
シュウトメ	姑
コウゾク	後続
トウノ	当の
トウジ	当事
デアイ	出合い
ミアタラナイ	見当たらない
ソクシ	即死
ドウギョウ	同業
マカス	負かす
オンブ	負んぶ
フクショク	服飾
オマケ	お負け
アミ	網
ソウ	沿う
シジン	詩人
ムカシ	昔
テンメツ	点滅
トゲル	遂げる
テイジ	定時
ハンエイ	繁栄
ヘンイ	変移
サシアタリ	差し当たり
ユビサス	指差す
チョウ	兆
ドノ	殿
ヒトサシユビ	人差し指
マザル	混ざる
ギイン	議院
ジンジイン	人事院
センポウ	戦法
ウヨク	右翼
サヨク	左翼
ツバサ	翼
リョウ	猟
カタオモイ	片思い
ナラス	慣らす
ウシ	牛
ギュウニク	牛肉
ジサク	自作
タテカエル	立て替える
ナキゴエ	泣き声
ニンゲンテキ	人間的
トビアガル	飛び上がる
ブブンテキ	部分的
テキ	敵
ヒャッカジテン	百科辞典
ハツユキ	初雪
ミリョク	魅力
マッキテキ	末期的
キライ	嫌い
サンセン	三選
シンリガク	心理学
オトロエル	衰える
イヤ	嫌
カエリミル	顧みる
セイスル	制する
トメル	泊める
モシモ	若しも
リッコク	立国
ネマキ	寝間着
コオル	凍る
イチニ	一二
ヒキカエス	引返す
キワメテ	極めて
ケツエキ	血液
ゴテ	後手
イキカエル	生返る
ブレイ	無礼
サンド	三度
カクシュ	各種
タネ	種
チョウ	蝶
ネンサン	年産
ヒンケツ	貧血
ヒンコン	貧困
ベイジン	米人
キョウド	強度
シミル	染みる
シキチ	敷地
ユリ	百合
ヨウゴ	擁護
イショウ	衣装
イリョウ	衣料
チョウホウ	重宝
イエガラ	家柄
カタ	肩
コウケン	高見
ハライモドス	払い戻す
カタガキ	肩書
カタガワリ	肩代わり
チュウコウ	中高
エンガワ	縁側
エンダン	縁談
フクメル	含める
ドウジダイ	同時代
トウキ	当期
カミキ	上期
コマル	困る
サンカ	酸化
サンセイ	酸性
サンソ	酸素
ハツユメ	初夢
ホウケンテキ	封建的
アニ	兄
キョウダイ	兄弟
テモチ	手持ち
マギラワシイ	紛らわしい
リョウ	量
バッキン	罰金
バッソク	罰則
ノナカ	野中
ケッスル	決する
イカリ	怒り
オコル	怒る
ショウメツ	消滅
フタミ	二見
ヒジョウニ	非常に
オヨグ	泳ぐ
カネンブツ	可燃物
シュドウ	手動
タズネル	尋ねる
スイエイ	水泳
センテ	先手
レンドウ	連動
モヤス	燃やす
トセイ	都政
キソ	基礎
キョウセイ	共生
ジュウニブン	十二分
フユカイ	不愉快
ユカイ	愉快
チョウコウ	兆候
カタサ	堅さ
アマグ	雨具
ゴジ	誤字
フハイ	腐敗
カン	観
ゴジツ	後日
ソフ	祖父
ソボ	祖母
ボウセキ	紡績
シャメイ	社名
ヨウジ	幼児
イッセン	一戦
キャクホン	脚本
オモムキ	趣き
トトノエル	整える
セイスウ	整数
カンキ	乾期
カギ	鍵
シホンキン	資本金
ソウタイ	総体
ダンラク	段落
オウチャク	横着
ニモツ	荷物
シュッカ	出荷
ツウカン	通関
エリ	襟
シャガイ	社外
シオ	潮
ミワク	魅惑
ウメ	梅
オモテムキ	表向き
バカ	馬鹿
ジカ	自家
シュクハク	宿泊
コクサイジン	国際人
テジョウ	手錠
シュワ	手話
フカサ	深さ
ウスギ	薄着
ヨウジンブカイ	用心深い
ナサケブカイ	情け深い
ローマジ	ローマ字
コウセイ	後世
アザ	字
ジビキ	字引
ジカク	字画
クチゴタエ	口答え
シブル	渋る
ボク	僕
マイ	枚
サクラ	桜
ナメラカ	滑らか
シンタイ	新体
セイ	製
チョウジャ	長者
エンカツ	円滑
イチグン	一軍
コドク	孤独
コリツ	孤立
ヌル	塗る
カケ	賭け
オウゴン	黄金
コガネ	黄金
コウブンショ	公文書
ゼンブン	全文
ミステル	見捨てる
ドウオン	同音
ハンタイセイ	反体制
イチゲン	一元
ミホンイチ	見本市
シセイ	市政
オカス	冒す
ホショウ	保障
メイゲツ	明月
モウシブンナイ	申し分無い
バイショウ	賠償
サマ	様
ヨウ	様
キノドク	気の毒
ナカガイ	仲買
ハイク	俳句
モンク	文句
ゲツナイ	月内
シュセン	主戦
ジュミョウ	寿命
セツモン	設問
センダイ	千代
エハガキ	絵葉書
タテフダ	立て札
カイシン	改新
ゼンメツ	全滅
ヒカクテキ	比較的
サス	注す
チュウイブカイ	注意深い
ヨウチュウイ	要注意
ヨンホン	四本
ネエサン	姉さん
ドウスウ	同数
ネンスウ	年数
アラス	荒す
イマヒトツ	今一つ
ソウリダイジン	総理大臣
ダイジン	大臣
カイセイ	回生
クサリ	鎖
サコク	鎖国
タチ	達
ニイン	二院
クサル	腐る
ヘイサ	閉鎖
チチュウカイ	地中海
イッシン	一新
ウンヨク	運良く
シキサイ	色彩
フハツ	不発
テギワヨク	手際良く
ヒトツヒトツ	一つ一つ
ヒビク	響く
トリカカル	取り掛かる
ショカイ	初回
ショシュツ	初出
ネンショ	年初
ゴウキン	合金
ガッサク	合作
リテン	利点
オカエリナサイ	お帰りなさい
ドウアゲ	胴上げ
アイショウ	相性
クミタテ	組み立て
オカエリ	お帰り
ゴウホウテキ	合法的
コクチ	告知
セイソウ	清掃
ソウジ	掃除
ダイダイテキ	大々的
クモ	雲
キセイ	既製
コウミンケン	公民権
シミンケン	市民権
キョウケン	強権
ジッケン	実権
ヨウハ	要は
マガリ	間借り
カンシンジ	関心事
ショシンシャ	初心者
スイリョウ	推量
ジミチ	地道
ハックツ	発掘
タテ	縦
フキコム	吹き込む
ソウジュウ	操縦
ニホンダテ	二本立て
タチアイ	立ち会い
ネガオ	寝顔
ツキル	尽きる
セイジリョク	政治力
カイハツブ	開発部
テゴロ	手ごろ
ツドイ	集い
アイテカタ	相手方
チョチク	貯蓄
シュチュウ	手中
ダイサンゴク	第三国
ザイライ	在来
ジザイ	自在
ジク	軸
ヒトナカ	人中
トウム	党務
オバケ	御化け
アンケン	案件
キョウダイ	強大
ケットウ	結党
コウテンテキ	後天的
ジュンサ	巡査
マチドオシイ	待ち遠しい
テンキヨホウ	天気予報
テッペン	天辺
テンプラ	天ぷら
アマノガワ	天の川
ニンキモノ	人気者
ダンイン	団員
ニュウダン	入団
ツカレ	疲れ
ヒロウ	疲労
ケイト	毛糸
ザンパイ	惨敗
サンパイ	惨敗
ランカク	乱獲
イチモン	一問
イッシュン	一瞬
ゲンブツ	現物
シュンカン	瞬間
セイブツガク	生物学
カテン	加点
イチダイ	一代
オシエゴ	教え子
ヤブレル	敗れる
サンダイ	三代
イチゴ	一期
ミナサン	皆さん
ヒショ	避暑
コウシ	公子
コウヨウ	公用
ヒキウケ	引き受け
チホウコウムイン	地方公務員
モチマエ	持ち前
ジュウナン	柔軟
ヒトミ	瞳
フジュン	不純
セック	節句
ギテイショ	議定書
シンショ	新書
キシャ	汽車
キュウシンリョク	求心力
フンカ	噴火
スシ	寿司
ヤシュ	野手
イタル	至る
ハツバショ	初場所
ショテイ	所定
ツキアタリ	突き当たり
ニュウショ	入所
キメ	決め
ケツ	決
ナニトゾ	何卒
ムスビツキ	結び付き
ホコリ	誇り
チョウエツ	超越
ノバス	延ばす
セキトリ	関取
アマモリ	雨漏り
スイジョウ	水上
センシュ	先取
メサキ	目先
ギセイ	犠牲
ネダル	強請る
ゼンチョウ	全長
チツジョ	秩序
アメフリ	雨降り
ドノグライ	どの位
ドノクライ	どの位
ウンテンシ	運転士
サッコン	昨今
テイコク	帝国
テンカ	添加
テンプ	添付
マキゾエ	巻き添え
フタツメ	二つ目
トキホグス	解きほぐす
ヒョウケツ	表決
ヒヤアセ	冷や汗
ギョウセイキカン	行政機関
トシケイカク	都市計画
ゲンシ	原資
アシカラズ	悪しからず
ワルギ	悪気
サンジカン	参事官
カワカミ	川上
ゾウサン	増産
ゾウシ	増資
ゾウセツ	増設
カカリチョウ	係長
コウハツ	後発
ジハツ	自発
ヨゴス	汚す
アイダジュウ	間中
スモウ	相撲
ホンケ	本家
メイゲン	明言
モチイエ	持ち家
クロウト	玄人
トウケツ	凍結
ハクジャク	薄弱
レイトウ	冷凍
カワグチ	川口
コウカイ	後悔
ツイデ	序で
ショウシャ	勝者
シンジョウ	心情
ホリ	堀
イッセイ	一世
クヤシイ	悔しい
タクワエル	蓄える
ケッショウテン	決勝点
ショメン	書面
タイメン	対面
トウニュウ	投入
ハラ	腹
トウカ	投下
トウシン	投信
イシヒョウジ	意思表示
シタジキ	下敷
キク	菊
カダン	花壇
シキブトン	敷布団
ドンブリ	丼
キク	効く
ギュウニュウ	牛乳
キョウダ	強打
コウイシツ	更衣室
ズシ	図示
セイズ	製図
タモクテキ	多目的
ウチダス	打ち出す
チチ	乳
ブンカ	分化
マジュツ	魔術
ズウズウシイ	図々しい
タハツ	多発
ケムリ	煙
キンエン	禁煙
サライシュウ	再来週
サンナン	三男
ジュクゴ	熟語
ゼンブン	前文
トウミン	冬眠
シンデン	新田
ブンカジン	文化人
フチ	縁
エンギ	縁起
ハンベイ	反米
ムエン	無縁
マル	丸
マルッキリ	丸っきり
ガンポン	元本
チュウゲン	中元
マンマル	真ん丸
シメッポイ	湿っぽい
マルマル	丸まる
タシャ	他者
タメン	他面
タバネル	束ねる
ボウダイ	膨大
ナオシ	直し
ヒョウダイ	表題
コイ	恋
レンアイ	恋愛
コイビト	恋人
シタジ	下地
ジュク	塾
キグ	危惧
シメキリ	締切り
シメキリ	締切
トリシマリ	取締まり
トリシマリ	取り締り
トリシマリ	取締り
ミカケル	見かける
ヒキシメ	引締め
サイカ	最下
ハバタク	羽撃く
ハブク	省く
チンプ	陳腐
カッキ	画期
キュウ	旧
コンバン	今晩
シュキ	手記
ニホンガ	日本画
ユウダチ	夕立
カイチュウ	海中
クルウ	狂う
キンカイ	近海
シツ	室
トショシツ	図書室
マチアイシツ	待合室
コワガル	怖がる
ホッカイ	北海
サンセン	参戦
カタヅク	片付く
ミャクハク	脈拍
シッケイ	失敬
オモムキ	趣
ソンチョウ	村長
チョウエキ	懲役
ホクジョウ	北上
リアゲ	利上げ
キンコウ	近郊
コウガイ	郊外
トリカエル	取り替える
ブジョク	侮辱
アルク	歩く
ホコウシャ	歩行者
ホコウシャテンゴク	歩行者天国
シュタイテキ	主体的
メズラシイ	珍しい
ニンチ	認知
ゲンダイテキ	現代的
コシ	腰
ゼンケン	全権
リツアン	立案
ヨゲン	預言
ホウヨウ	法要
ジチケン	自治権
セイアン	成案
キャクマ	客間
コクダイ	国大
セキタン	石炭
オモイツク	思いつく
ジセイ	自制
テイジセイ	定時制
オドリ	踊り
トナリアウ	隣り合う
フキダス	吹き出す
トナリアワセ	隣り合わせ
キュウキョ	急きょ
ギンガミ	銀紙
ゼンジ	全治
ハヤネ	早寝
チリガミ	ちり紙
シュウヤク	集約
ニジ	虹
ヒョウショウ	表彰
ボツラク	没落
ジッセイ	実勢
ゲンサン	減産
ザイガイ	在外
ショウギ	将棋
ザイキョウ	在京
イッケン	一件
エンシュウ	円周
コムスビ	小結
ダイホン	台本
ホウチョウ	包丁
イキ	意気
コクサイキョウリョクジギョウダン	国際協力事業団
ケツベツ	決別
コウレイ	恒例
ツム	摘む
リキテン	力点
カタヨル	偏る
コウガクネン	高学年
フセイリツ	不成立
セイキョウ	政教
イチニン	一任
キョウエン	共演
ニン	任
マカス	任す
ブンケイ	文系
ボウケン	冒険
ボウトウ	冒頭
マイゴ	迷子
リケイ	理系
タコ	凧
カンチガイ	勘違い
ユウキ	勇気
ショカ	書家
テイジュウ	定住
フケン	府県
ボコクゴ	母国語
ヤゴウ	野合
ヤスイ	易い
キカイ	機械
シツレン	失恋
ショザイチ	所在地
コイシイ	恋しい
コイスル	恋する
ショヨウ	所要
エシャク	会釈
ケナゲ	健気
ゲンジン	原人
サイ	才
リンリ	倫理
ウケツケ	受け付け
トリサゲ	取り下げ
テトリ	手取り
スウジ	数次
ヒトリッコ	一人っ子
アマエル	甘える
ツド	都度
クセ	癖
ツキヅキ	月々
マックロ	真っ黒
チカスイ	地下水
スイドウスイ	水道水
キオク	記憶
ショウカキ	消火器
アラアラシイ	荒々しい
ボヤ	小火
コウハンセン	後半戦
キョウフ	恐怖
アヤマル	誤る
サイゲン	再現
ガラスド	ガラス戸
サイカイハツ	再開発
オロカ	愚か
イヌ	犬
コウケン	後見
ハヤク	速く
トジコモル	閉じこもる
サクネンライ	昨年来
ダイミョウ	大名
オモテダッテ	表立って
オモテダツ	表立つ
ヤサイ	野菜
ロンチョウ	論調
ロンテン	論点
ドウメイ	同名
ナザシ	名指し
マジエル	交える
コウセン	交戦
ミミ	耳
ロジ	露地
ケイカクテキ	計画的
マッコウ	真っ向
センザイ	潜在
ソウリョク	総力
イッツウ	一通
キョウカン	教官
ツトメル	勤める
ジョリュウ	女流
リュウドウテキ	流動的
トビキリ	飛び切り
ヒキノバス	引き伸ばす
ヒキノバス	引き伸す
ヒキノバス	引伸ばす
ヒキノバス	引伸す
ブツリュウ	物流
カンキ	寒気
サムケ	寒気
カンレイ	寒冷
コシカケル	腰掛ける
サッキ	殺気
ゾウイン	増員
ユゲ	湯気
ソウホンザン	総本山
サンヤ	山野
ジョウガイ	場外
ホンザン	本山
ノヤマ	野山
リョウユウ	領有
マエウリケン	前売り券
オハナシチュウ	お話し中
イチタイイチ	一対一
ニシグチ	西口
セキメン	赤面
カド	過度
ガイネン	概念
セイジョウ	政情
コウソク	拘束
ゼンブ	前部
タンスウ	単数
デシイリ	弟子入り
リキトウ	力投
ナゲ	投げ
セイリガク	生理学
オリカエス	折り返す
ハカ	墓
ボチ	墓地
シメシ	示し
コウアンイインカイ	公安委員会
チンモク	沈黙
ダマル	黙る
グンセイ	軍政
ジュウミンゼイ	住民税
ニグン	二軍
ヒッス	必須
ダリョク	打力
シャミントウ	社民党
クラヤミ	暗やみ
ナニトゾ	何とぞ
ケンモン	検問
ヤブレル	破れる
ヘンケン	偏見
ヘンサチ	偏差値
コクブンガク	国文学
タイチ	対地
ノキナミ	軒並み
ヨビステ	呼び捨て
ゾッコウ	続行
カエ	代え
フンイキ	雰囲気
ジュウダイ	１０代
ジゾクテキ	持続的
イチゲンカ	一元化
カラス	烏
コウシ	公私
チョウソン	町村
チョウミン	町民
タマゴ	卵
コウシン	後進
シガク	私学
シブンショ	私文書
シンシン	新進
ジョウジ	常時
ジョウセツ	常設
ジョウレン	常連
セイトウ	正統
タイグウ	待遇
ジュウド	重度
ヤエ	八重
ジュウテンテキ	重点的
ヤスラギ	安らぎ
ミズウミ	湖
トリノゾク	取り除く
ノゾク	除く
コエル	肥える
ウチウチ	内々
チカヅキ	近づき
ヤスラグ	安らぐ
コウキョウリョウキン	公共料金
カイトリ	買取
ボウトウ	暴騰
アイマッテ	相まって
デナオシ	出直し
オロス	降ろす
チホウギョウセイ	地方行政
キツエン	喫煙
キッサテン	喫茶店
ソエン	疎遠
スバラシイ	素晴しい
リョウロン	両論
サイテイ	裁定
ヒキノバス	引き延す
ヒキノバス	引延ばす
ヒキノバス	引延す
ショクタク	食卓
ナシトゲル	成し遂げる
タスウケツ	多数決
ホンスウ	本数
カンショウ	干渉
マツル	祭る
ジャッカン	若干
ナラベル	並べる
メイガ	名画
カクイツ	画一
ホス	干す
ケンコク	建国
コウカイ	公海
ヒトゴミ	人込み
チョウテン	頂点
ガイチュウ	害虫
カオブレ	顔ぶれ
カタリ	語り
シタガエル	従える
ムシ	虫
インサツ	印刷
カカル	掛かる
シキュウ	死球
ニクガン	肉眼
ウリアゲキン	売上金
ショキュウ	初球
カビン	花瓶
サホウ	作法
ムラビト	村人
キタアイルランド	北アイルランド
リキサク	力作
ミミモト	耳元
センシュムラ	選手村
シュギョウ	修行
ウマ	午
ヒル	午
ボウキャク	忘却
ナラス	鳴らす
カワル	替わる
カイウン	海運
ジュウショク	住職
ギアン	議案
サンケン	三権
シュツニュウ	出入
タイアン	対案
テンカ	転嫁
ニュウトウ	入党
リッショウ	立証
センキョケン	選挙権
ジンシン	人心
ハコ	箱
ホンド	本土
シドウ	市道
ダイドウ	大道
シンヨウクミアイ	信用組合
メイボ	名簿
トウヨ	投与
シンセカイ	新世界
オジョウサン	お嬢さん
カイジョウ	開場
ネカス	寝かす
トクサク	得策
カイコク	開国
オテアゲ	お手上げ
テダテ	手立て
ソウゼイ	総勢
トメガネ	止め金
コクセイチョウサ	国勢調査
シュウ	集
トクシュ	特殊
チョウチョウ	蝶々
ゲッサン	月産
カンブン	漢文
ゴウリョク	合力
ハンショク	繁殖
レンケツ	連結
ナゼカ	何故か
ジリキ	地力
ガクギョウ	学業
センスイカン	潜水艦
ニヒャクハツカ	二百二十日
シゲル	茂る
チホウコウキョウダンタイ	地方公共団体
フリムク	振り向く
センベツ	選別
フカブン	不可分
ベツイン	別院
ベツジン	別人
コウハイ	後輩
コモノ	小物
センパイ	先輩
ブッサン	物産
ヤクショク	役職
ダイドウ	大同
アナ	穴
アガル	揚がる
セイキョウ	正教
フドウサンヤ	不動産屋
トキトシテ	時として
エンモク	演目
カイホウ	会報
キミョウ	奇妙
ホウ	報
キセキ	奇跡
オンドク	音読
オンヨミ	音読み
ジマン	自慢
デンワキ	電話機
ナイジツ	内実
ハイケン	拝見
ヒツドク	必読
マンセイ	慢性
タチヨミ	立ち読み
ヒキアイ	引き合い
ワリダカ	割高
ワリヤス	割安
ジッソウ	実相
シヨウシャ	使用者
テガキ	手書き
ツル	鶴
ワキマエル	弁える
モチダシ	持ち出し
ゲヤ	下野
ネモト	根元
コンゲン	根元
カシキリ	貸し切り
ミノシロキンヨウキュウ	身代金要求
オンダン	温暖
コウサイヒ	交際費
コウヒ	工費
ショケン	所見
タイシャ	大社
レイコク	冷酷
セイソウ	政争
ゲンサン	原産
ヒタル	浸る
サンジ	三次
ニガミ	苦味
イキサキ	行き先
コウセイノウ	高性能
センダイ	先代
ハクシュ	拍手
ヨウスイ	用水
クギリ	区切り
ツク	就く
キラス	切らす
ゼンハンセン	前半戦
ハンセイ	半生
ムキ	無期
ダイジョウブ	大丈夫
ツメ	爪
ブッピン	物品
サンピン	産品
シンピン	新品
ロンセツ	論説
スイイ	水位
テンジル	転じる
テンキ	転機
テンショク	転職
ヒョウスル	表する
メイジツ	名実
メイシュ	名手
コウシ	小牛
タイロン	対論
ロンコク	論告
イバル	威張る
コウツウキカン	交通機関
ショクヨウ	食用
ホイクエン	保育園
サイボウ	細胞
トウケイ	東経
ヒジュウ	比重
ヤグ	夜具
シスル	資する
ツウ	通
ナン	難
ツウネン	通年
ゲザン	下山
カクヤス	格安
コシカケ	腰掛け
ゾウシン	増進
ナミダ	涙
ヤマヤマ	山々
カカリカン	係官
シユウ	私有
ヤキソバ	焼そば
ショクレキ	職歴
レンパツ	連発
カカリイン	係員
イヤガル	嫌がる
ユウジ	有事
カギョウ	家業
アンシンカン	安心感
サイカイ	際会
ニンゲンドック	人間ドック
サテイ	査定
ヒッテキ	匹敵
ヒキ	匹
トクセツ	特設
カダイ	過大
シュウブン	秋分
キュウカ	休暇
ヨカ	余暇
ショキキョク	書記局
オマエ	御前
サシシメス	指し示す
チョウチョウ	長調
ハイ	肺
ハイエン	肺炎
ホンチョウシ	本調子
ムジャキ	無邪気
サイネンショウ	最年少
ジョウタイ	上体
マゴ	孫
ダンゾク	断続
ホウシュツ	放出
ホンリョウ	本領
リョウジ	領事
ゼイホウ	税法
オシウリ	押売
オシウリ	押売り
タトエ	仮令
イチナン	一男
カワイガル	可愛がる
カワイラシイ	可愛らしい
ケンキョ	検挙
コウブン	公文
ネンパイ	年輩
ジンブン	人文
ブンキョウ	文教
ケンガイ	県外
イカク	威嚇
カンテイ	鑑定
ゴウギ	合議
トウホウ	当方
ナンポウ	南方
オヤスミナサイ	お休みなさい
ヒトヤスミ	一休み
ヤスメル	休める
タズサワル	携わる
シセツ	私設
シイク	飼育
ハッポウ	八方
オヤスミ	お休み
シミンシャカイ	市民社会
シダイ	私大
オンジン	恩人
サンバシ	桟橋
カサネアワセ	重ね合わせ
オモル	重る
デアシ	出足
セイジョウカ	正常化
タジュウ	多重
カジュウ	加重
ススメル	勧める
ヤキトリ	焼鳥
イワカン	違和感
キンダイテキ	近代的
コウナイ	校内
サワガシイ	騒がしい
フシャ	富者
シヨウリョウ	使用料
シュタル	主たる
オトル	劣る
ハカル	謀る
チョッカ	直下
サンボウ	三方
イシツブツ	遺失物
キョウレツ	強烈
ミハラシ	見晴らし
カサイ	家裁
チョウデンドウ	超電導
アソコ	彼処
インズウ	員数
バンヅケ	番付
アマミ	甘味
イヒョウ	意表
イッパンニ	一般に
サンパツ	散髪
ゼンキ	前記
コム	混む
ホカク	保革
アンカ	安価
ケンセツテキ	建設的
ゲンコウ	原稿
ハズカシイ	恥ずかしい
ツウイン	通院
ヒツジ	未
ウチウミ	内海
サンジョ	三女
サンカク	参画
エダ	枝
フセン	不戦
フモン	不問
ナレル	慣れる
ウリダシ	売り出し
チキュウジョウ	地球上
ミセバ	見せ場
キュウカイ	球界
ショネン	初年
エイダン	営団
シエイ	市営
ソンミン	村民
トウリ	党利
レンサク	連作
サンブサク	三部作
トエイ	都営
クウゼン	空前
コクミンセイ	国民性
シャカイセイ	社会性
ニヅクリ	荷造り
ミシラヌ	見知らぬ
ザイショク	在職
オヤコウコウ	親孝行
フロ	風呂
ウタウ	謡う
オカ	丘
リッタイテキ	立体的
サショウ	査証
ムネ	棟
ツキサス	突き刺す
ハシ	箸
ミイル	見入る
イッシン	一心
ケンドウ	県道
サンドウ	山道
フヨウイ	不用意
カイドウ	海道
ハテ	果て
カケアシ	駆け足
コウシン	交信
ジュシンキ	受信機
ショ	諸
ショコク	諸国
マンガ	漫画
クッセツ	屈折
ゲンカン	玄関
ネカセル	寝かせる
ナツバテ	夏ばて
キュウピッチ	急ピッチ
カキ	夏期
テガケル	手がける
テゴワイ	手ごわい
シュウキン	集金
アラテ	新手
ネバリ	粘り
ニホン	日本
シュウタイセイ	集大成
カクゴ	覚悟
サンテイ	算定
テンザイ	点在
ナクナル	亡くなる
ナクス	亡くす
オイカケル	追いかける
ザイベイ	在米
ケッシャ	結社
ゴハン	御飯
テンポ	店舗
ハカマイリ	墓参り
キョウダン	教団
グンダン	軍団
フニンキ	不人気
アマノガワ	天の河
コサジ	小さじ
キイロイ	黄色い
カゴウブツ	化合物
コウクウケン	航空券
タカラカ	高らか
モノワカレ	物別れ
カセイ	化成
ケイセイ	京成
ケイゴ	警護
タイセイ	大成
オオジダイ	大時代
カイエン	開演
アツイ	暑い
センニン	選任
タイボク	大木
サマス	冷ます
ジニン	自任
チョット	鳥渡
オンケイ	恩恵
ジッチ	実地
ツカノマ	束の間
デンドウ	電動
ケイザイケンキュウショ	経済研究所
キョウショ	教書
ドク	毒
ヤワラカ	軟らか
ホンダナ	本棚
ヤジルシ	矢印
ユウドク	有毒
モチマワリ	持ち回り
クウセキ	空席
ネザス	根ざす
ジュウニン	住人
ミエ	見栄
ミバエ	見栄
カンペキ	完ぺき
チョウシン	長身
レンカン	連関
オウフク	往復
シュッピ	出費
ユシュツニュウ	輸出入
ジケツ	自決
イチヅケ	位置付け
ゲンセイ	原生
ジダイ	次代
スケット	助っ人
ツキ	付き
イチヅケル	位置付ける
ジッシ	実子
トリタテ	取り立て
ソウダンジョ	相談所
ヨリアツマル	寄り集まる
シセイ	施政
トウト	東都
ミスイ	未遂
チカヨセル	近寄せる
セコウ	施工
シュスイ	取水
セイジャク	静寂
バン	晩
ハンハン	半々
ウチキリ	打ち切り
ムトクテン	無得点
マルメコム	丸め込む
コメル	込める
サイライ	再来
ウチョウテン	有頂天
タテコム	立て込む
ゼンガク	全学
チャクモク	着目
ワカレメ	分かれ目
カオナジミ	顔なじみ
ヒノメ	日の目
キシュ	機首
ジョウハツ	蒸発
シンズイ	神髄
ナノリ	名乗り
レンメイ	連名
ダイカイテン	大回転
キギョウカ	企業家
ハカリシレナイ	計り知れない
コリル	懲りる
テンシュ	店主
ルイ	類
ヒラチ	平地
アウ	遭う
キョム	虚無
シカツ	死活
マショウメン	真正面
スイシ	水死
ソウアタリ	総当たり
ソウドウイン	総動員
イッポウツウコウ	一方通行
ナンダイ	難題
ホンリュウ	本流
アカリ	灯り
ヨソ	余所
ヨホド	余程
サンセン	山川
ヨソウガイ	予想外
タチイリキンシ	立ち入り禁止
タチイリキンシ	立入禁止
タチイリキンシ	立入り禁止
タチイリキンシ	立ち入禁止
サイゼンセン	最前線
セイコウ	性向
ミトメイン	認め印
ユウリョクシャ	有力者
ダイイッセン	第一線
ノボセル	逆上せる
イウマデモナイ	言うまでもない
シャタイ	車体
セイカ	生家
サカサマ	逆様
ケイザイセイチョウリツ	経済成長率
ネンリツ	年率
トクヤク	特約
ナンビョウ	難病
マクラ	枕
リクツ	理屈
セイジンビョウ	成人病
センショウ	戦勝
カンジョウテキ	感情的
ジョウホウブ	情報部
シタテナゲ	下手投げ
カイキョク	開局
キョクイン	局員
シュケイキョク	主計局
レントウ	連投
ガック	学区
クギ	区議
ゲッシュウ	月収
チュウセン	抽選
チョウメ	丁目
ブドウ	武道
ナイジ	内示
セイエン	声援
セイガク	声楽
ダンコウ	断行
イチダ	一打
カセグ	稼ぐ
トモカセギ	共稼ぎ
セイカガク	生化学
ミチノリ	道程
ホウテイ	法廷
トドケ	届け
チホウゼイ	地方税
イチモン	一文
ヒキモドス	引戻す
ナニモノ	何者
ギネン	疑念
ネムル	眠る
キュウユジョ	給油所
ヒトリボッチ	独りぼっち
ショウネンバ	正念場
ナンカイ	南海
キタイカン	期待感
オオアタリ	大当たり
イエモト	家元
キスウ	奇数
シセイカツ	私生活
シアン	試案
アツサ	暑さ
ススミ	進み
ドセキ	土石
レイカ	零下
イチゾク	一族
カゾクケイカク	家族計画
アシドリ	足取り
アシバ	足場
ゾク	族
ドウサツ	洞察
ブゾク	部族
アライモノ	洗い物
ヤスアガリ	安上がり
マキコム	巻込む
シメル	占める
ドクヤク	毒薬
マチガイナイ	間違いない
コウセツ	公設
ショウレイ	奨励
チシマ	千島
ミンシュコク	民主国
シマグニ	島国
オチツク	落ちつく
コウイキ	広域
シズム	沈む
ソムク	背く
イモウト	妹
シカ	詩歌
シイカ	詩歌
チイキシャカイ	地域社会
ダイスル	題する
タスケ	助け
ジョヤク	助役
リョウグン	両軍
シャクジン	石神
ジジョ	自助
カジョウ	過剰
ジッスウ	実数
ドスウ	度数
タイハイテキ	退廃的
コウホウ	工法
ダイタン	大胆
フジュウブン	不充分
ゼンエイ	前衛
ダンコ	断固
コオリ	氷
ゲンカ	原価
ヤトイヌシ	雇主
ブッカシスウ	物価指数
センイ	繊維
イチジョ	一女
ヒッカカル	引っ掛る
カクヤク	確約
シュッテン	出展
テンジカイ	展示会
オサナイ	幼い
ハナシカケル	話し掛ける
シシキュウ	四死球
キョコウ	虚構
セイコウ	性行
ナル	鳴る
コンニチテキ	今日的
セイショ	清書
ボウ	棒
サムサ	寒さ
ジッショウ	実証
ニンショウ	認証
オヤガイシャ	親会社
ハツアン	発案
ココロイキ	心意気
センキョニン	選挙人
ゼンニチセイ	全日制
タヨリナイ	頼りない
オウキュウ	応急
キュウム	急務
ニシドイツ	西ドイツ
セイホウ	西方
テチョウ	手帳
キュウセイチョウ	急成長
ハイシン	配信
シハイニン	支配人
シハイテキ	支配的
ホウチコク	法治国
ガイロン	概論
キセイ	気勢
ハナバナシイ	華々しい
ミオボエ	見覚え
モノオボエ	物覚え
トウセイ	党勢
オサン	お産
キョウユ	教諭
ケイヨウシ	形容詞
ジムテキ	事務的
ソウリョウ	送料
メベリ	目減り
ソウキュウ	送球
タカダイ	高台
サイシン	再審
トリカエル	取り換える
オリガミ	折紙
イチダン	一団
ジョウブン	条文
シンジョウ	信条
ニヒャクトオカ	二百十日
ヒサン	悲惨
キニイリ	気に入り
ショウセン	商戦
イッパ	一派
ギャクサツ	虐殺
シュカン	主幹
ヒッショウ	必勝
ホンヤク	翻訳
オウブン	応分
キョウム	教務
ケイシ	警視
ケイブ	警部
ココロガマエ	心構え
ツイラク	墜落
セイヤク	成約
コウホウ	公報
シキュウ	子宮
ヌマ	沼
シンニン	新任
ハッテントジョウコク	発展途上国
キバ	木場
ロウドウジョウケン	労働条件
インキ	陰気
コウジン	公人
ヒキトリ	引き取り
ジユウガタ	自由形
クトウテン	句読点
ケイヒン	景品
ゲイノウジン	芸能人
モチダス	持ち出す
モチアイ	持ち合い
ノミモノ	飲物
キュウラク	急落
イサギヨイ	潔い
ジセキ	次席
シンジョウ	身上
オチ	落ち
リッポウフ	立法府
エハガキ	絵はがき
キョウシュウ	郷愁
ケイソウ	係争
サトウ	砂糖
ジヒ	自費
ホクオウ	北欧
シュッショ	出所
センピ	戦費
マドリ	間取り
シュウサイ	秀才
フヨ	付与
トリキメル	取り決める
アンラクシ	安楽死
アマヤカス	甘やかす
アネ	姉
カグラ	神楽
スイサンブツ	水産物
サキヤス	先安
ブンラク	文楽
ヤッカイ	厄介
シマイ	姉妹
リコシュギ	利己主義
コテサキ	小手先
キョウガク	共学
キョウリツ	共立
キョウワセイ	共和制
カミ	髪
シモハンキ	下半期
ケッキ	決起
タイジョウ	退場
ワギ	和議
コウスイジュン	高水準
ショウボウショ	消防署
トクイサキ	得意先
ヒキヌク	引き抜く
ヒキヌク	引抜く
チャクヨウ	着用
オイヌク	追い抜く
テンサク	添削
ツキヌケル	突き抜ける
ヌク	抜く
ヌケル	抜ける
フクショウ	副賞
スル	刷る
ダトウ	妥当
テンヨウ	転用
マユ	眉
ブンミャク	文脈
ミャク	脈
テンテン	転々
ホウホウロン	方法論
ショクドウ	食道
タキ	滝
ヘイホウキロメートル	平方キロメートル
クウキョ	空虚
ケンゾウブツ	建造物
シュウシュウ	収拾
ダイベン	大便
ボンオドリ	盆踊り
コウタイ	交替
ソクタツビン	速達便
ゾウセイ	造成
キドウ	軌道
トリノコス	取り残す
ツイシン	追伸
リュウヨウ	流用
ショキカン	書記官
カンセン	幹線
デムク	出向く
タイコウ	対向
ヘイコウセン	平行線
ボウガイ	妨害
ユウジン	有人
ユウセン	有線
オモイオモイ	思い思い
モチカブ	持ち株
バステイ	バス停
カジン	家人
コウトウ	口頭
ショトウ	初頭
タイカン	体感
タイトウ	台頭
トウブ	頭部
コクサイレンゴウ	国際連合
ジカヨウ	自家用
ギホウ	技法
クチブリ	口ぶり
コクギ	国技
シジョウチョウサ	市場調査
ヒガシグチ	東口
クチグチ	口々
ビョウリ	病理
カトウ	過当
ネバル	粘る
マサツ	摩擦
ヨウチ	幼稚
イキスギル	行き過ぎる
ジョウホウカシャカイ	情報化社会
ノウギョウキョウドウクミアイ	農業協同組合
ゲツメン	月面
ミウケル	見受ける
ジュリ	受理
シュウキョク	終局
ショタイメン	初対面
メンメン	面々
ウケトリニン	受取人
シュウト	州都
シュウセイフ	州政府
イイン	医院
イキョク	医局
カンジ	漢字
タマネギ	玉ねぎ
サイショウ	最少
ハカマイリ	墓参
ショウスウイケン	少数意見
ミジメ	惨め
イト	糸
シュリョウ	首領
ダイイッセイ	第一声
テバナシ	手放し
カカル	懸かる
シツテキ	質的
ゼイビキ	税引き
ベッソウ	別荘
ダツイ	脱衣
シュゼイキョク	主税局
ケンシュツ	検出
ケンカ	県下
ケンジセイ	検事正
メイブンカ	明文化
ハンキョウ	反共
ツクル	創る
マチ	待ち
イッセキ	一石
サワル	障る
アジワイ	味わい
シアン	私案
チョウギカイ	町議会
ココノエ	九重
ツギハギ	継ぎはぎ
スッパイ	酸っぱい
リョウソク	両足
サイジュウテン	最重点
オモキ	重き
ヤスラカ	安らか
テハジメ	手始め
ゼンコウ	全校
ニュウカク	入閣
チカヂカ	近々
ガッコウホウジン	学校法人
シュウゼン	修繕
スイギン	水銀
ヤチヨ	八千代
セギン	世銀
サイバイ	栽培
テナオシ	手直し
チョッコウ	直行
フルウ	奮う
クウイキ	空域
サイノウ	才能
ユウカイ	誘拐
ロウム	労務
ジュウハチバン	十八番
ヒャクジュウキュウバン	一一九番
イチレイ	一例
キモ	胆
カンイッパツ	間一髪
ゲツレイ	月例
ゲンガ	原画
コウイン	工員
サガク	差額
ジョウキ	上記
ジンコウテキ	人工的
ツトメテ	努めて
ラクサ	落差
リコウ	理工
レイカイ	例会
ゴエイ	護衛
ムダヅカイ	無駄遣い
イッコ	一個
カタリクチ	語り口
ゴキ	語気
サンジ	参事
シジョ	子女
シキジョウ	式場
カタヨル	片寄る
ゴコク	護国
アセ	汗
サイショク	菜食
シン	芯
セイゼイ	精々
ヒビキ	響
ハヤ	早
ジツリ	実利
チョクエイ	直営
ミンエイカ	民営化
カンムリ	冠
キタグニ	北国
ギインウンエイイインカイ	議院運営委員会
ソンギカイ	村議会
キカセル	利かせる
クウチョウ	空調
コウヒョウ	好評
シャメン	斜面
クミ	組み
テイヒョウ	定評
キュウショク	求職
フチジ	府知事
ドウ	銅
セイセン	生鮮
ヨウショク	要職
カガミ	鏡
ソナエ	備え
シンコウ	親交
シンショ	親書
キョトウ	挙党
シャタク	社宅
シュツド	出土
シンガイ	心外
サンヨ	参与
チラカス	散らかす
セカイタイセン	世界大戦
ハイソウ	配送
ガシュウ	画集
ショウキョク	消極
テンランカイ	展覧会
スル	擦る
タイセイ	体勢
カサン	加算
トモ	伴
ドウシュ	同種
ショクシュ	職種
ムスビツキ	結びつき
ムスビツク	結びつく
シカイ	視界
フエル	殖える
カントン	広東
コンブ	昆布
アクマ	悪魔
キカン	基幹
ソダイ	粗大
マホウ	魔法
サンベツ	産別
ブッテキ	物的
ホウシュウ	報酬
ヨシアシ	善し悪し
モノイイ	物言い
ジユウシュギ	自由主義
マチヤクバ	町役場
オンリョウ	音量
ムラサキ	紫
ジデン	自伝
デンキ	伝記
キュウチュウ	宮中
ジツエン	実演
トウグウ	東宮
アツカマシイ	厚かましい
コウイ	厚意
アツギ	厚着
ハツデンキ	発電機
テビキショ	手引書
モンヨウ	文様
キンク	禁句
ゲンリョウ	減量
シシャ	使者
ショイン	書院
ショタイ	書体
ヨウリョウ	容量
リキリョウ	力量
カキアゲル	書き上げる
シンブンキジ	新聞記事
テキレイキ	適齢期
テンラク	転落
モチヅキ	望月
ラクセン	落選
セバメル	狭める
ケツボウ	欠乏
アタタカイ	暖かい
タテフダ	立札
コウショ	高所
シショ	支所
カクヅケ	格付け
ゲンサンチ	原産地
ヒゴウホウ	非合法
トリツギ	取次
ニナイテ	担い手
オトズレ	訪れ
カゲツ	カ月
カゲツ	ケ月
カゲツ	ヶ月
カゲツ	ヵ月
チスイ	治水
スイサンギョウ	水産業
サキドリ	先取り
センジン	先人
センポウ	先方
ラン	欄
キテン	起点
ゼンリャク	前略
ウチキル	打ち切る
ハンキ	半期
リャク	略
ホボ	略
リャクス	略す
モノホシ	物干し
キリサゲ	切り下げ
サイコウ	再考
ショウヒン	小品
ショウガイ	生涯
カジ	舵
キンピン	金品
カンセン	観戦
ナギサ	渚
ショウセツカ	小説家
テイセツ	定説
ウカレル	浮かれる
ウク	浮く
ショメイ	書名
ショウソ	勝訴
オキバ	置き場
テンシン	転身
テンバイ	転売
フキソ	不起訴
キッカケ	切掛
オイカケル	追い掛ける
ケンサツカン	検察官
ウワノセ	上乗せ
ホシモノ	乾物
シュケイ	主計
セイゴウ	整合
アサイ	浅い
ビン	瓶
マジリ	交じり
トリハカライ	取り計らい
ダンボール	段ボール
ジゴク	地獄
トツジョ	突如
ジュンジュンニ	順々に
ジュンロ	順路
オウリョウ	横領
カイナン	海難
カンカイ	官界
カンポウ	官報
ジムカン	事務官
タナン	多難
キハン	軌範
ハイセキ	排斥
ヒンカク	品格
リソウテキ	理想的
タットイ	尊い
キンユウシジョウ	金融市場
ユウワ	融和
ゾウスイ	増水
シャセン	車線
シンボウ	辛抱
ユウヨウ	有用
カセイ	家政
ガン	癌
ギョウカン	行間
シャケン	車検
シュットウ	出頭
チョウコク	彫刻
オモシロ	面白
ガクサイ	学際
コウリツ	高率
シャチュウ	車中
カシコイ	賢い
タエズ	絶えず
タエマナク	絶え間なく
ダンユウ	男優
トクダイ	特大
ハダギ	肌着
ビョウメイ	病名
ユウセンテキ	優先的
ゼッタイニ	絶対に
トリクチ	取り口
タイビョウ	大病
トクベツク	特別区
イッカ	一過
ウソ	嘘
オダヤカ	穏やか
オンケン	穏健
カゴン	過言
キツネ	狐
タイショウ	大勝
テイスイジュン	低水準
テイチョウ	低調
ネンチャク	粘着
ナイジョウ	内情
ノウサクブツ	農作物
ノウガクブ	農学部
イッキョク	一局
キョクチ	局地
コウシュウ	広州
ウワテナゲ	上手投げ
フシアワセ	不幸せ
ブキョク	部局
タクミ	巧み
シュジイ	主治医
シュウヨウ	収用
ダンメン	断面
フクゲン	復元
ホウスイ	放水
ムジュン	矛盾
ノバナシ	野放し
シャコク	社告
シアガリ	仕上がり
シシツ	資質
シンケイシツ	神経質
オシイレ	押し入れ
オシイレ	押入
オシイレ	押入れ
ウチアイ	打ち合い
ニコム	煮込む
タイキョ	退去
オオムギ	大麦
トシオトコ	年男
ブンチュウ	文中
ヒルガエス	翻す
ムネン	無念
カイケイケンサイン	会計検査院
ホウブン	法文
サギ	詐欺
シシャゴニュウ	四捨五入
ステル	捨てる
トウチ	倒置
ナンボクモンダイ	南北問題
イミアイ	意味合い
シキンセキ	試金石
シサク	試作
ジョウシン	上申
モウシデ	申し出
チカウ	誓う
ツリ	釣り
ナイシン	内申
シャミセン	三味線
ソノホカ	その他
カン	缶
タガヤス	耕す
シヨウ	仕様
センメンキ	洗面器
センレン	洗練
オイメ	負い目
サマガワリ	様変わり
ハクガク	博学
ハキモノ	履物
キンサク	近作
ナイカクホウセイキョク	内閣法制局
イス	椅子
イッセン	一千
オロス	卸す
カイコウ	開港
トウナイ	島内
ホントウ	本島
ケショウ	化粧
オロシウリ	卸売り
ガクシキ	学識
キョウチ	境地
スイイキ	水域
タチナオリ	立ち直り
アタタマル	暖まる
チシキジン	知識人
イチリョウ	一両
テダスケ	手助け
メガミ	女神
カトウ	下等
アオムケ	仰向け
アマミ	甘み
ナイキ	内規
ムサベツ	無差別
リコウガクブ	理工学部
レイガイテキ	例外的
ベニ	紅
クレナイ	紅
コウサクイン	工作員
イクブン	幾分
コウシュウデンワ	公衆電話
カイセン	海戦
コノエ	近衛
イッシキ	一式
タイソウ	大層
ナガメ	眺め
コウシ	子牛
イトナミ	営み
ミミザワリ	耳障り
ブンキ	分岐
ヨウダイ	容態
フケル	老ける
ルイケイ	類型
テサゲ	手提げ
シンクウ	真空
オオゾラ	大空
ヒョウギイン	評議員
ホンショウ	本性
ウツシダス	映し出す
ダイエイ	大映
カゲン	下限
カクウ	架空
カスル	課する
カンチ	関知
カギリナイ	限りない
ヨツカド	四つ角
ショッケン	職権
マシカク	真四角
ボンジン	凡人
アキル	飽きる
アカシ	証
シンエイ	親衛
センモンテン	専門店
ツヤ	艶
オニ	鬼
ミソコナウ	見損なう
トリアツカイ	取扱い
トリアツカイ	取り扱
トリアツカイ	取扱
ソンスル	損する
ショミン	庶民
ソウカン	総監
ホル	彫る
ガイカイ	外界
グンバイ	軍配
コショ	古書
サイコ	最古
ネマキ	寝巻き
ネマキ	寝巻
ハダ	肌
クバリモノ	配り物
フクダイ	副題
ヨウチエン	幼稚園
レイジョウ	礼状
コッカシケン	国家試験
クツ	靴
ソウデン	送電
オイウチ	追い打ち
ミンカンホウソウ	民間放送
カンゴ	漢語
キョウコク	強国
ダイチ	台地
テンリ	天理
ウラモン	裏門
アキナイ	商い
ショウヨウ	商用
ゲンダンカイ	現段階
オオアキナイ	大商い
イジン	偉人
マボロシ	幻
ゲンソウ	幻想
アイコトバ	合言葉
カゲノナイカク	影の内閣
イチジンブツ	一人物
シンギ	信義
タイギメイブン	大義名分
ヒンパツ	頻発
モノゴコロ	物心
ホンメイ	本命
ヒソカ	密か
カンセイ	管制
ショカン	所管
マチハズレ	町はずれ
ツル	釣る
ランケイ	卵形
タマゴガタ	卵形
キギ	木々
ナイゾウ	内蔵
エンカ	演歌
カンヨウク	慣用句
ツカイワケ	使い分け
ジツリョクコウシ	実力行使
セイキョウイク	性教育
セイイク	生育
ホトケ	仏
リョウテキ	量的
キキガキ	聞き書き
ジッセン	実践
ブラク	部落
セバマル	狭まる
クウユ	空輸
キズク	築く
トボシイ	乏しい
カソ	過疎
ミクダス	見下す
ジテン	次点
オロカ	疎か
オロソカ	疎か
ニノツギ	二の次
ミンペイ	民兵
グンピョウ	軍兵
カタン	加担
カンセツテキ	間接的
シンコウ	信仰
ミズケ	水気
セッテン	接点
ヨボウセッシュ	予防接種
スイリ	水利
サビシイ	寂しい
キレメ	切れ目
ムリシ	無利子
ムサク	無策
セイキュウケン	請求権
サイニン	再任
マットウ	全う
デンキ	電器
ヒンセイ	品性
バンコク	万国
ジユウケイザイ	自由経済
ロウドウキジュンホウ	労働基準法
ノル	載る
コウイ	高位
ブイ	部位
トカス	解かす
クウテン	空転
グウスウ	偶数
ジョウムイン	乗務員
セイロン	正論
ロンガイ	論外
カイケイネンド	会計年度
サイケントウ	再検討
オコタル	怠る
オオダナ	大店
カクダン	格段
カエリミチ	帰り道
ケイロ	経路
マップタツ	真っ二つ
セッチュウ	折衷
カワリ	替わり
ダン	段
シニタイ	死に体
ワルサ	悪さ
ジュナン	受難
センス	扇子
センプウキ	扇風機
ダイカン	代官
タンカ	担架
リュウハ	流派
ショウトウ	消灯
ナサル	為さる
ヨメ	嫁
キョウカ	教科
ボウクウ	防空
ゾウハツ	増発
ツユイリ	入梅
ニュウバイ	入梅
シンカブ	新株
ソウカンカンケイ	相関関係
シンコウ	進攻
カンド	感度
コウゴウ	皇后
オクラス	遅らす
キョウトウ	教頭
ショウリツ	勝率
テイリツ	定率
ジビョウ	持病
スイシン	水深
ミズグチ	水口
エイジ	英字
ジョウカン	情感
テイリ	低利
ノウサギョウ	農作業
コクジョウ	国情
キョウサイ	共催
ナゲダス	投げ出す
ヒトエ	単
ホウセイキョク	法制局
トウシュセン	投手戦
カイギョウイ	開業医
サイブ	細部
シキキン	敷金
アサゴハン	朝御飯
ヌクモリ	温もり
コウリツテキ	効率的
サツ	冊
ジヘン	事変
コワダカ	声高
フクチョウ	復調
モクセイ	木製
アタタメル	温める
ニオイ	匂い
シキリ	仕切り
ドロ	泥
ケッセントウヒョウ	決選投票
ムトウヒョウ	無投票
フリツケ	振り付け
ケンカイ	県会
マネク	招く
ツウネン	通念
タンボ	田んぼ
ヒンパン	頻繁
サイコウケン	最高検
コト	琴
シュウセキ	集積
マタセル	待たせる
カミ	加味
シカイ	市会
シケン	私見
タシツ	多湿
モウテン	盲点
ガンキン	元金
キンセキ	金石
カンヅメ	缶詰め
ジフ	自負
ミンゾクジケツ	民族自決
シゾク	氏族
カイコウ	開校
ゲンキュウ	言及
ザイ	財
ブンコウ	分校
イサマシイ	勇ましい
ノミコム	飲み込む
カクナイ	閣内
ザイセイトウユウシ	財政投融資
アンジュウ	安住
コウワン	港湾
イタメル	傷める
レットウカン	劣等感
ユギン	輸銀
オウジョウ	往生
ヒラキナオル	開き直る
トウチョク	当直
モンダイイシキ	問題意識
イソウ	移送
コオウ	呼応
アサガタ	朝方
ヌウ	縫う
ホンチョウ	本朝
ロウカ	廊下
コクロウ	国労
シンキュウ	新旧
アラワス	著す
アラワス	著わす
ツウレイ	通例
ショウサ	小差
テンサ	点差
イッシツ	一室
カッコ	確固
スミ	隅
ニホンシキ	日本式
リョウシキ	良識
リョウシツ	良質
シゼンカイ	自然界
シキブ	式部
ダイシゼン	大自然
コウキョウガク	交響楽
アル	在る
ソメル	初める
スイジ	炊事
ハイグウシャ	配偶者
トウカク	当確
カスミ	霞
ケンエイ	県営
シュッチョウジョ	出張所
ヒロウ	拾う
シュウトク	拾得
ヒョウケツ	評決
アユミ	歩み
ロンピョウ	論評
シュウカンシ	週刊誌
ショクノウ	職能
センド	鮮度
ヘイボン	平凡
ホンショク	本職
アカリ	灯
シャカイウンドウ	社会運動
センニン	専任
センモンテキ	専門的
ブッショウ	物証
サマタゲル	妨げる
ホシュテキ	保守的
ヨル	拠る
カンリ	監理
アタマキン	頭金
リョウフウ	涼風
イゴ	囲碁
カイキ	怪奇
カンタン	感嘆
イニシエ	古
コト	古都
シンブンシ	新聞紙
チュウコシャ	中古車
ワシ	和紙
コウバシイ	香ばしい
アヤシイ	怪しい
カク	欠く
カケル	欠ける
カケラ	欠けら
ツドウ	集う
フウゾク	風俗
ゲキヘン	激変
シケンジョウ	試験場
シケンテキ	試験的
イマサラ	今更
シリョウ	史料
ドウシ	動詞
サバク	砂漠
ヨフケ	夜更け
シュウチ	周知
テンシ	天使
テンネンキネンブツ	天然記念物
カゼ	風邪
ケンシ	検視
ビジュツテン	美術展
イシカイ	医師会
ショウガク	商学
キザイ	機材
ジンメイ	人命
ヨッパラウ	酔っ払う
ダイヤク	代役
ドウギ	道義
メイウン	命運
マンマン	満々
マンキ	満期
コヤク	子役
コクイッコクト	刻一刻と
ニグウ	二宮
ロウドウウンドウ	労働運動
マルマル	丸々
モッコウ	木工
ケイジョウ	形状
ケイセイ	形勢
タイケイ	体形
キタエル	鍛える
デンカ	電化
デンシン	電信
オガム	拝む
ハイケイ	拝啓
コクサイデンシンデンワ	国際電信電話
ショゾウ	所蔵
コッカ	国歌
モッテクル	持ってくる
モッテクル	持って来る
ジョウケイ	情景
リョウサン	量産
シャカイキョウイク	社会教育
クウボ	空母
ミブンショウメイショ	身分証明書
ブンシン	分身
ラクゴカ	落語家
カシキリ	貸切り
フキダス	噴き出す
ミウゴキ	身動き
カイツケ	買い付け
マツバラ	松原
チュウオウ	中欧
ツキ	突き
ダッコ	抱っこ
ヒックリカエル	引っ繰り返る
ジダン	示談
ヒタス	浸す
ヘイイン	兵員
ホケンショ	保健所
カンセツゼイ	間接税
コッカイ	黒海
シンゲキ	進撃
ミズギワ	水際
セッシュ	接種
チョクセツテキ	直接的
ニンシン	妊娠
ノウドウ	能動
コノンデ	好んで
カキ	火器
ミワケル	見分ける
イイキル	言い切る
シュッカ	出火
アカイ	紅い
ヒキドキ	退き時
フタイテン	不退転
ホウシ	奉仕
ムキリョク	無気力
ムセイフ	無政府
シタウケ	下請け
マツリ	祭
タイエキ	退役
ムキメイ	無記名
ヒグチ	火口
タチノキ	立ち退き
コスウ	戸数
ワタシタチ	私達
ドキ	土器
セッキ	石器
シキ	士気
ショウヨ	賞与
エガク	描く
ツキソイ	付添い
ヒンイ	品位
カイメイ	改名
カンサツ	監察
ワカメ	和布
ムシアツイ	蒸し暑い
テンシュツ	転出
ドウジョウ	同乗
カワカス	乾かす
シンペン	身辺
セイ	姓
ソウケイ	総計
ドウセイ	同姓
オソルベキ	恐るべき
シキギョウ	私企業
カショウヒョウカ	過小評価
ケンゾウ	建造
マウエ	真上
マアタラシイ	真新しい
ヘンゾウ	変造
シリュウ	支流
ジリュウ	時流
トビダシ	飛び出し
カクアゲ	格上げ
ソロバン	算盤
タットブ	尊ぶ
ムシカク	無資格
ヒギシャ	被疑者
ゲンケイ	原型
コウユウ	公有
ジンミンセンセン	人民戦線
チュウガタ	中型
ハナ	鼻
カブケン	株券
ギシン	疑心
ゴカン	五感
タテガキ	縦書き
マエガシラ	前頭
ズジョウ	頭上
フロウシャ	浮浪者
アタマウチ	頭打ち
トナリアウ	隣合う
トナリアワセ	隣合わせ
ミキリハッシャ	見切り発車
マグチ	間口
コウジョウ	口上
クチキキ	口利き
ソウトク	総督
キタグチ	北口
カタ	過多
ジュギョウリョウ	授業料
テイガクネン	低学年
テイラク	低落
ツブ	粒
ジヒ	慈悲
タンカ	単価
オマワリサン	お巡りさん
イチョウ	医長
トオク	遠く
コマカ	細か
カゼグスリ	風邪薬
コウヨウ	効用
ダンジキ	断食
ヨウロウイン	養老院
ホヨウジョ	保養所
リョウヨウジョ	療養所
ヨウゴ	養護
ホウリュウ	放流
コトワリ	断り
フクトウ	復党
イダイ	偉大
イトテキ	意図的
コウヒンシツ	高品質
シタテ	仕立て
ズシキ	図式
ナニヤラ	何やら
コウキョウ	好況
ソウジュク	早熟
ナンニモ	何にも
オキザリ	置き去り
オンド	音頭
ガイ	街
ウワヅミ	上積み
ミナミグチ	南口
ナンコク	南国
フキョウワオン	不協和音
ツミカサネ	積み重ね
キョシテキ	巨視的
シブツ	私物
シュウカク	収穫
ダイリセキ	大理石
モウシアワセ	申し合わせ
キオイ	気負い
フルエル	震える
ネガワクハ	願わくは
ジョメイ	除名
ムリヤリ	無理矢理
イッコウ	一校
ショウヒザイ	消費財
ジョガッコウ	女学校
ツイトウ	追悼
ゴハン	ご飯
テワタス	手渡す
ワタリ	渡り
ジョウシキテキ	常識的
ヨコス	寄越す
ケッサイ	決裁
コチョウ	誇張
テアタリシダイ	手当たり次第
ノリコス	乗り越す
ノリコス	乗越す
シンガク	神学
ノリコシ	乗り越し
ノリコシ	乗越し
ギョウセイショブン	行政処分
チョウトウハ	超党派
トクシツ	得失
イチバンテ	一番手
ウワサ	噂
ヨビダシ	呼び出し
イマヒトツ	今一
サクバン	昨晩
フニン	赴任
ウケオイ	請負
エンダテ	円建て
ケンギ	建議
コンリュウ	建立
コシツ	個室
ハジル	恥じる
ウレエル	憂える
ジシツ	自室
ニホンガクジュツカイギ	日本学術会議
コタイ	個体
アワタダシイ	慌ただしい
サイリョウ	最良
ヤケ	自棄
シンゴ	新語
シゴ	私語
キンヨクテキ	禁欲的
ヨクブカ	欲深
キメダマ	決め球
カイシュウ	改修
セイメイ	姓名
セイタイガク	生態学
フレル	触れる
ボン	盆
アキヤ	空き家
カイヘイタイ	海兵隊
ホウチ	報知
カイジョウジエイタイ	海上自衛隊
キンシン	近親
シュウマツ	終末
オヤブン	親分
タイガン	対岸
ウミノオヤ	生みの親
センモンイ	専門医
キャクイン	客員
ボウズ	坊主
コクドチリイン	国土地理院
シンカラ	心から
ココロカラ	心から
ワカバ	若葉
ソシキテキ	組織的
ジャクネン	若年
リガイカンケイ	利害関係
イソギ	急ぎ
キュウシ	急死
ココン	古今
チヂメル	縮める
チヂレル	縮れる
ムハイ	無配
ハイホン	配本
ハイヤク	配役
セイシ	製紙
セル	競る
オレイ	お礼
セリアウ	競り合う
エンザン	演算
サンシュツ	算出
ソウケン	送検
コウキョウホウソウ	公共放送
ジュウカサンゼイ	重加算税
オイアゲル	追い上げる
オクリダシ	送り出し
テンモン	天文
テンモンガク	天文学
テンモンダイ	天文台
ビガク	美学
ツクリワライ	作り笑い
シジ	師事
カワ	河
オカシナ	可笑しな
ネンショウ	年商
エライ	偉い
タガイチガイ	互い違い
テキシュツ	摘出
キュウスイ	給水
ヨッパライ	酔っ払い
ゼンタイシュギ	全体主義
メイダイ	命題
メイメイ	命名
ジュキュウ	受給
ヤクマワリ	役回り
アタリヤク	当たり役
ヤクニタタナイ	役に立たない
イッパイ	一敗
ガンユウ	含有
デンソウ	伝送
デンドウ	伝道
ハイシャ	敗者
ハイソ	敗訴
ハイタイ	敗退
イカン	移管
カンク	管区
ニュウコクカンリキョク	入国管理局
モトキ	本木
キノミ	木の実
ユチャク	癒着
ハイカン	配管
フクスケ	福助
ハタラカセル	働かせる
ゲンケイ	原形
ミズワリ	水割り
ゾウショ	蔵書
ケンキュウカン	研究官
ナカナオリ	仲直り
サンリョウ	産量
ムジュウリョウ	無重量
イッシン	一身
ミガワリ	身代わり
シマネ	島根
ボコウ	母校
ミバエ	見栄え
カイアゲ	買い上げ
カイサツグチ	改札口
ツクエ	机
セマイ	狭い
イッショク	一色
ホウオウ	訪欧
ワカマツ	若松
クキョウ	苦境
ニガオエ	似顔絵
マネル	真似る
ツマサキ	つま先
シュショウ	首唱
チョクセツセンキョ	直接選挙
キシカイセイ	起死回生
タイカン	退官
タイサ	大佐
オモイオコス	思い起こす
イッコダテ	一戸建て
カクカゾク	核家族
メグム	恵む
シノブ	忍ぶ
マンガイチ	万が一
マンネン	万年
モンコ	門戸
メグマレル	恵まれる
ヤムヲエナイ	やむを得ない
ケイジバン	掲示板
シカン	士官
ヨワムシ	弱虫
センシ	戦士
チャクチ	着地
グウゾウ	偶像
サッチ	察知
ソウジョウ	相乗
ブンジョウ	分乗
ナノリデル	名乗り出る
ナノル	名乗る
ヨウモウ	羊毛
ジハン	自販
テンセン	転戦
ショクゴ	食後
ホリョ	捕虜
ツユ	露
ハナゾノ	花園
カツロ	活路
グタイカ	具体化
クウロ	空路
スイロ	水路
ヒフ	皮膚
ハルバショ	春場所
ニホンドウロコウダン	日本道路公団
ヨコメ	横目
ヨコテ	横手
イシツ	異質
イショク	異色
イヘン	異変
ガイマイ	外米
ニゲアシ	逃げ足
イカン	遺憾
イッチョクセン	一直線
マエガリ	前借り
チュウオウシュウケン	中央集権
ハイセン	配線
レンケイ	連係
ススメル	薦める
ユルメル	緩める
ゲンメイ	言明
ダイシャ	台車
ジス	辞す
オセッカイ	お節介
オセチリョウリ	お節料理
セキグン	赤軍
トクチョウ	特長
ユウカン	勇敢
ジツギ	実技
メイユウ	名優
ミヤマ	深山
シュンジュウ	春秋
カシラモジ	頭文字
ノウサン	農産
ヒツジュヒン	必需品
エイノウ	営農
ノウチカイカク	農地改革
ノウホウ	農法
ジキョク	時局
コル	凝る
サス	射す
ムシャ	武者
フヤス	殖やす
オサマリ	収まり
カタムケル	傾ける
コンチュウ	昆虫
カタムク	傾く
カシゲル	傾げる
イキトドク	行き届く
デンピョウ	伝票
トドク	届く
トドケル	届ける
ヘンシツ	変質
ムゼイ	無税
トケコム	溶け込む
ヒョウデン	票田
アオバ	青葉
ケイバジョウ	競馬場
ブッシツテキ	物質的
アワレ	哀れ
キンヨウビ	金曜日
ゲツヨウビ	月曜日
ゾウニ	雑煮
スイヨウビ	水曜日
ゼンシュウ	前週
ドヨウビ	土曜日
ドウセイアイ	同性愛
ニチヨウビ	日曜日
ヤブリ	破り
ネムイ	眠い
モクヨウビ	木曜日
ナニゲナイ	何気ない
サッキョウシスウ	作況指数
オンシツ	音質
セイナン	西南
セキ	積
ツミタテキン	積立金
ヨクヨウ	抑揚
カンノン	観音
マチアイ	待合
マタス	待たす
キュウセン	休戦
シコウ	試行
シリ	尻
トウセキ	投石
アジツケ	味付け
キレアジ	切れ味
バッスイ	抜粋
マク	巻く
ザイセイナン	財政難
コモリウタ	子守歌
トリマク	取り巻く
タバ	把
ザイムカン	財務官
タチギエ	立ち消え
ギジロク	議事録
ケンシキ	見識
シキシャ	識者
センイキ	戦域
フワタリ	不渡り
ユウユウ	悠々
メンシキ	面識
イシキテキ	意識的
キロクテキ	記録的
イチジョ	一助
ジョエン	助演
ノボリクダリ	上り下り
ジョウホウショリ	情報処理
テイネイ	丁寧
インセキ	引責
サイホウ	裁縫
センタク	洗濯
ロウサク	労作
フネンブツ	不燃物
ショウリョク	省力
キュウセイ	旧制
ショウガイ	渉外
ウメボシ	梅干
アマヤドリ	雨宿り
コウシュウエイセイ	公衆衛生
シュウ	衆
ジュツ	術
ジュツゴ	術後
ケンセイ	憲政
ゴソウ	護送
シゴ	死語
シヨウ	枝葉
エダハ	枝葉
ヨキ	良き
イッショニ	一緒に
アシバヤ	足早
ナイショ	内緒
ネコ	猫
ハクサイ	白菜
ジュセイ	受精
モンゼン	門前
ハシワタシ	橋渡し
シシャ	試写
センシュウ	専修
ビンヅメ	瓶詰
ホシュウ	補修
ミハリ	見張り
ヒトリアルキ	独り歩き
アルキマワル	歩き回る
ホヘイ	歩兵
ツツミガミ	包み紙
ホウカゴ	放課後
リョウ	寮
アキ	飽き
スイトウ	水筒
ヨビヒ	予備費
ネンガク	年額
バカラシイ	馬鹿らしい
キョウコウサイケツ	強行採決
カヨワイ	か弱い
サクフウ	作風
ジャク	弱
ニゴル	濁る
タニマ	谷間
トウ	塔
カゼアタリ	風当たり
カンジョウ	環状
カエッテ	却って
シメイテハイ	指名手配
ハイデン	配電
コシ	古紙
キョウバイ	競売
ハシタナイ	端たない
チケン	治験
ゴウヒ	合否
シボウリツ	死亡率
ソウケッサン	総決算
コタエル	答える
メイシ	名詞
サンシュ	三種
ホンヨサン	本予算
シュシン	主審
オレル	折れる
テンジン	天神
テンチ	天地
ヤシキ	屋敷
イチジョウ	一条
ナエ	苗
ホンカン	本館
カンナイ	館内
ギギ	疑義
ギエンキン	義援金
ゲンギ	原義
ゲンザイリョウ	原材料
コウコウ	航行
マンカイ	満開
カタガキ	肩書き
ヤタイ	屋台
シカシ	併し
タイハイ	大敗
ケイ	系
シュカン	主管
アジキナイ	味気ない
ミチクサ	道草
カンクキショウダイ	管区気象台
ガイデン	外電
テッテイテキ	徹底的
インショクテン	飲食店
インリョウスイ	飲料水
トダナ	戸棚
ベンゴニン	弁護人
キョウイクシャ	教育者
ムリョウ	無量
スイリョウ	水量
キョウイクテキ	教育的
ゲンジュウミン	原住民
オチド	落ち度
ラクガキ	落書き
キズツク	傷付く
ホボ	保母
カイイレ	買い入れ
トウラク	当落
ツッパリ	突っ張り
ヒキシマル	引き締る
ライホウ	来訪
ヨセ	寄せ
セッチャク	接着
ドウコウ	同好
コウケイキ	好景気
コウラクチ	行楽地
ヒダネ	火種
キコウ	起工
ゲンタイ	減退
コウエキ	公益
クチビ	口火
コクエキ	国益
シュウガク	就学
ウケオウ	請け負う
タイシャ	退社
ウリコミ	売り込み
イッチャク	一着
キョウソウ	競走
コクシ	国士
ゼイリシ	税理士
ドクソウ	独走
ソッコウ	速攻
イチバンノリ	一番乗り
ソツイ	訴追
エンチョウ	園長
カイカ	開花
タベスギル	食べ過ぎる
ミセサキ	店先
ヘンキョウ	辺境
ヤボ	野暮
ライテン	来店
オセイボ	お歳暮
ツマ	具
ジョジ	女児
ゾウゴ	造語
ヒガワリ	日替わり
ヒガワリ	日替り
シンシュン	新春
ロメン	路面
アクテンコウ	悪天候
エイブンガク	英文学
エイチ	英知
エイメイ	英明
ゲカイ	外科医
キュウケイ	休憩
コウカ	工科
ユウゴウ	融合
アズカリジョ	預かり所
シャカイカ	社会科
インショウテキ	印象的
ヤク	焼く
ヤケル	焼ける
スキヤキ	すき焼き
スキヤキ	すき焼
ヤキモチ	焼きもち
ヤキモチ	焼もち
ギャクフウ	逆風
スイシャ	水車
メガシラ	目頭
セキガイセン	赤外線
ドウビョウ	同病
ハダイロ	肌色
タイショウ	大将
ジケイ	字形
ソデ	袖
インガ	因果
サトル	悟る
ハイイン	敗因
ヒョウテキ	標的
ミゾ	溝
イノル	祈る
トクセイ	特製
コゴエ	小声
フクイン	復員
ゲンチ	言質
スイミン	睡眠
ソクバク	束縛
タンジカン	短時間
シュウヒョウ	集票
バケン	馬券
アオジャシン	青写真
アイジン	愛人
カッキョウ	活況
ゲンキョウ	現況
ユウアイ	友愛
カイヘン	改編
チョウヘン	長編
テキギ	適宜
キュウスル	休する
キュウショク	休職
シショク	試食
シリョウ	試料
コイシ	小石
チョウニン	町人
ボウシ	帽子
ボウソウ	暴走
タハ	他派
ダイカゾク	大家族
キショウダイ	気象台
マギラス	紛らす
アゲク	挙げ句
アゲク	挙句
カイシメ	買い占め
タラス	垂らす
スウハイ	崇拝
ホカン	補完
カシマ	貸間
カト	過渡
ウケワタシ	受け渡し
ヒッシ	必至
イイワタシ	言い渡し
ワタシ	渡し
タスケアイ	助け合い
ウツリカワリ	移り変わり
サンセイ	三省
ゼンパイ	全廃
ソクセイ	促成
ホンショウ	本省
ロウ	労
タマシイ	魂
セキニンカン	責任感
テンイ	転移
ショウエネルギー	省エネルギー
キュウライ	旧来
ドウショクブツ	動植物
ボクチク	牧畜
ガンジョウ	頑丈
シツナイガク	室内楽
ジッケンシツ	実験室
セイトウボウエイ	正当防衛
ヘイガイ	弊害
ミカイケツ	未解決
ムロマチ	室町
ネッセン	熱戦
ドウゼン	同然
ホンルイ	本塁
ツキソイ	付き添い
ココジン	個々人
トリアエズ	取りあえず
センパク	船舶
フヒョウ	不評
アヤブム	危ぶむ
グンシュウ	群集
フリダシ	振り出し
ヨウ	酔う
オシイ	惜しい
オクサン	奥さん
ジュンスイ	純粋
ウルオウ	潤う
ヤワラカイ	軟らかい
ツメル	詰める
コウエキ	交易
ズイブン	随分
ケンザイ	健在
タンジョウビ	誕生日
デムカエル	出迎える
ジュンズル	準ずる
ガクシ	学士
コウタク	光沢
トオリカカル	通り掛かる
カケザン	掛け算
コウズイ	洪水
イケル	生ける
ジョウダン	冗談
セイホウ	製法
リョウチ	領地
カリ	仮
カナヅカイ	仮名遣い
フリガナ	振り仮名
オクリガナ	送り仮名
タンペン	短編
シンシ	紳士
ワブン	和文
サク	裂く
サケル	裂ける
シメル	湿る
モウシイレル	申し入れる
ゾウリ	草履
ヒトスジ	一筋
タレル	垂れる
ゼヒトモ	是非とも
ハダカ	裸
キップ	切符
シヘイ	紙幣
ウツシ	写し
イド	緯度
ケイコウトウ	蛍光灯
タイクツ	退屈
ヤムヲエナイ	止むを得ない
タイブ	大部
サラ	皿
ゼンセイ	全盛
コウテイ	肯定
サイゼン	最善
サクゴ	錯誤
メシアガル	召し上がる
キカイ	器械
フゴウ	符号
ゼンカイ	全快
オバ	叔母
ゴラク	娯楽
ウヤマウ	敬う
ケイグ	敬具
ユレル	揺れる
サムイ	寒い
サイ	差異
テノヒラ	掌
カイキョウ	海峡
ニモカカワラズ	にも拘らず
オンチュウ	御中
スイゲン	水源
カクレル	隠れる
ヘン	編
ジョコウ	徐行
フルサト	古里
キンコウ	均衡
スム	澄む
ミニクイ	醜い
ウワマワル	上回る
タッシャ	達者
シタガッテ	従って
ナマゴミ	生ごみ
クミ	組
キョウシュウ	教習
ホホエム	微笑む
カスカ	微か
ニシビ	西日
カイソウ	回送
シバラク	暫く
アライ	粗い
トビラ	扉
オバ	伯母
コンゴウ	混合
サイジツ	祭日
イキゴム	意気込む
ゲタ	下駄
ケイキ	計器
フリコム	振り込む
シボウ	脂肪
マコト	誠
ワスレル	忘れる
ケライ	家来
フク	吹く
コウギョウ	興業
ナマグサイ	生臭い
ハナハダ	甚だ
ヤコウ	夜行
ザッカ	雑貨
アイダガラ	間柄
マネキ	招き
オドロク	驚く
ショウミ	正味
ボウフウ	暴風
カネツ	加熱
イクツ	幾つ
デキル	出来る
セトモノ	瀬戸物
マタハ	又は
オイ	老い
ツラヌク	貫く
キガイ	危害
センセイ	専制
ナグサメル	慰める
ジョシ	助詞
ホウズル	報ずる
オテアライ	お手洗い
ガッチ	合致
シタビ	下火
ボウハン	防犯
コウ	請う
トコヤ	床屋
シタウ	慕う
シモ	霜
ライジョウ	来場
ギンミ	吟味
ヤツ	奴
ユケツ	輸血
シオカライ	塩辛い
オイワイ	お祝い
ドウキュウ	同級
サンゴ	産後
デクワス	出くわす
サエギル	遮る
ガチ	雅致
ワクセイ	惑星
シュッシャ	出社
アオグ	仰ぐ
ブシュ	部首
ドンカン	鈍感
カイソウ	階層
キメイ	記名
サラニ	更に
デキルダケ	出来るだけ
ツグナイ	償い
ゾウ	像
ハテル	果てる
イッセイニ	一斉に
シク	敷く
カスル	化する
アラスジ	粗筋
カミツ	過密
コボス	零す
ヨミアゲル	読み上げる
オニイサン	お兄さん
フケツ	不潔
メッタニ	滅多に
キヨ	寄与
オジイサン	お祖父さん
オバアサン	お祖母さん
サンシュツ	産出
ホヨウ	保養
リレキ	履歴
キヒン	気品
イタメル	炒める
ショハン	初版
マタ	又
メイサン	名産
モチ	餅
ハク	掃く
フウシュウ	風習
ジビカ	耳鼻科
オオキナ	大きな
カガヤク	輝く
タイシテ	対して
チョウ	長
デアイ	出会い
ホカク	捕獲
トブ	跳ぶ
オダイジニ	お大事に
シズメル	沈める
コクテイ	国定
ジゼン	事前
ゼンジツ	前日
ネンセイ	年生
ナク	鳴く
イチレン	一連
ニクム	憎む
コゴエル	凍える
オナカ	お腹
ナガナガ	長々
ケムイ	煙い
ケムタイ	煙たい
ケムル	煙る
ドクソウ	独創
ゴウ	業
ヤハリ	矢張り
モル	漏る
モレル	漏れる
シュゴ	主語
エサ	餌
オモチャ	玩具
ワケ	訳
ジリツ	自立
オドル	踊る
トイアワセ	問い合わせ
ネムタイ	眠たい
ハツガ	発芽
イイツケル	言い付ける
シュツドウ	出動
トウキョウ	東京
フコク	布告
センリョク	戦力
カイロ	海路
キョウショク	教職
クシ	櫛
トウボウ	逃亡
ダッスル	脱する
ヨウホウ	用法
ウジ	氏
ゲンコウ	現行
タイガイ	大概
ガンセキ	岩石
ホウシャ	放射
ゴザイマス	ご座います
オシキル	押し切る
ハネル	跳ねる
ナマミ	生身
オビル	帯びる
シュホウ	手法
イタダク	頂く
フチョウ	不調
ダメ	駄目
アリノママ	有りのまま
タビタビ	度々
マレ	稀
ミカケ	見掛け
イッテキマス	行って来ます
ツクリ	作り
マシタ	真下
ゴウリュウ	合流
ユノミ	湯飲み
セイ	制
イチド	一度
ギョウム	業務
コトニ	殊に
イッキ	一気
トク	溶く
トケル	溶ける
サクセイ	作成
シュジンコウ	主人公
ヤセイ	野生
キョウカイ	協会
キョウチョウ	協調
キョウテイ	協定
アタタメル	暖める
ヒドリ	日取り
クモル	曇る
ユウベ	夕べ
ホガラカ	朗らか
リャクダツ	略奪
ナク	泣く
ドウテキ	動的
イシ	意思
シソク	子息
ナヤマス	悩ます
ウケイレ	受け入れ
チク	地区
オシコム	押し込む
カゲ	陰
メイメイ	銘々
コウドク	購読
ヒザ	膝
カイテイ	改定
クンシュ	君主
チョゾウ	貯蔵
テンズル	転ずる
テンコウ	転校
ミハカラウ	見計らう
キリュウ	気流
キカン	季刊
シュウジ	習字
スズシイ	涼しい
カケル	賭ける
カネテ	兼ねて
ススメ	勧め
カンユウ	勧誘
テヂカ	手近
グンプク	軍服
センコウ	先行
キョウサン	共産
キョウワ	共和
メグミ	恵み
トクテン	得点
モサク	模索
コウジュツ	口述
メンジョ	免除
ゲンブン	原文
コガラ	小柄
タンパ	短波
デンライ	伝来
ガンネン	元年
シズク	滴
センコウ	選考
ケイコ	稽古
トリシラベル	取り調べる
トウキュウ	等級
ホメル	褒める
カセン	化繊
ウラム	恨む
ウレユキ	売れ行き
カワク	乾く
ドウカク	同格
ホウアン	法案
ホウサク	方策
マイゾウ	埋蔵
ケン	件
ツエ	杖
カエル	変える
ゼンリョウ	善良
ブツギ	物議
ブツリガク	物理学
シンニン	信任
ハサム	挟む
ショザイ	所在
ショジ	所持
ツギツギ	次々
オネエサン	お姉さん
ヨウヒン	用品
カンレイ	慣例
ロンギ	論議
シュウケイ	集計
チョウカン	長官
キコン	既婚
ゾウキョウ	増強
タチカタ	立方
シュクガ	祝賀
リョウキョク	両極
ハナハダシイ	甚だしい
カンワ	漢和
イッペン	一変
ツカエル	仕える
ダカイ	打開
キキン	基金
キョウイ	驚異
ワタリドリ	渡り鳥
ズミ	済み
オツカイ	お使い
チョクメン	直面
ホウビ	褒美
ヘンカク	変革
ソウ	添う
ヌスミ	盗み
ホウシキ	方式
ソエル	添える
ジテン	自転
テイジ	提示
シュウジツ	終日
ボッチャン	坊ちゃん
カンサイ	関西
メンドウクサイ	面倒臭い
ソリ	反り
モウシブン	申し分
ジュウ	住
ソラス	逸らす
ムコ	婿
サイハツ	再発
カイ	下位
ジョウイ	上位
キンガン	近眼
ケンサク	検索
テンニン	転任
ナオサラ	尚更
ホンカク	本格
ユウキ	有機
サク	咲く
アザムク	欺く
オツリ	お釣り
ツリアウ	釣り合う
ヤカン	薬缶
セイイク	成育
カレシ	彼氏
コウハイ	荒廃
シンロ	針路
ショク	職
サカバ	酒場
ショウゲン	証言
ショウニン	証人
ワズラワシイ	煩わしい
カンヨ	関与
スソ	裾
エモノ	獲物
シキル	仕切る
ニエル	煮える
ソクスル	即する
ドボク	土木
トナエル	唱える
キュウチ	旧知
ショクリョウヒン	食料品
クダク	砕く
クダケル	砕ける
カザグルマ	風車
ナゲク	嘆く
ユウイ	優位
ダンゲン	断言
ナニモ	何も
ナンベイ	南米
ハン	班
カシヤ	貸家
シタドリ	下取り
キカク	規格
キヤク	規約
ガクジュツ	学術
センジュツ	戦術
カソクド	加速度
シンテン	進展
タマタマ	偶々
カスム	霞む
シュドウ	主導
カイアク	改悪
ザンキン	残金
タク	宅
サイ	最
ミガク	磨く
ミンゾク	民俗
タダ	只
ケイビ	警備
ホイク	保育
イクセイ	育成
ハク	履く
チャッコウ	着工
シカケル	仕掛ける
モホウ	模倣
ナイセン	内線
キフウ	気風
ケガ	怪我
ガイヨウ	概要
ノウサンブツ	農産物
フクシ	副詞
シツギ	質疑
ジッシツ	実質
オナイドシ	同い年
ネン	念
スイテキ	水滴
キセン	汽船
イキガイ	域外
ジャリ	砂利
リュウイキ	流域
ショクエン	食塩
ソウ	然う
サッキュウ	早急
セイゼン	整然
チュウガエリ	宙返り
ビリョウ	微量
シンサ	審査
ショウ	商
タタム	畳む
シマ	縞
サンキュウ	産休
ケイタイ	形態
オヤジ	親父
コウタイ	後退
ジュンジル	準じる
ヒロウエン	披露宴
シッキャク	失脚
ツクリ	造り
ユサブル	揺さぶる
カガイ	課外
デコボコ	凸凹
ヌレル	濡れる
ケッコウ	決行
トリタテル	取り立てる
ムシロ	寧ろ
イコウ	移行
コベツ	個別
ダレカ	誰か
フモト	麓
ナマケル	怠ける
ショヒョウ	書評
クチズサム	口ずさむ
ワク	沸く
ボクシ	牧師
ウマイ	美味い
ユウビ	優美
ハイ	灰
フク	福
ゾウショウ	蔵相
オカシ	お菓子
フンシュツ	噴出
マメ	豆
イク	幾
ラッカン	楽観
カンテン	観点
ソクリョク	速力
ユウシ	融資
ホシュウ	補習
シタゴコロ	下心
ウカガウ	伺う
アコガレ	憧れ
ジタイ	字体
シンヤ	深夜
ニチヤ	日夜
フクラマス	膨らます
モチアゲル	持ち上げる
ハル	貼る
シンデン	神殿
トノサマ	殿様
ハルカ	遥か
イツ	何時
ケンヤク	倹約
サイクツ	採掘
コゼニ	小銭
コウコガク	考古学
トクハ	特派
ニオウ	臭う
ジョシ	女史
ササゲル	捧げる
ニカイダテ	二階建て
クギ	釘
タテ	盾
カンヨウ	寛容
タク	炊く
エイシャ	映写
クツガエス	覆す
マヌカレル	免れる
ノガス	逃す
セメ	攻め
スズム	涼む
インキョ	隠居
ホカ	他
キュウコン	球根
ハダシ	裸足
セッカイ	切開
フッキュウ	復旧
カイギシツ	会議室
ケンキュウシツ	研究室
イタダキ	頂
ノド	喉
ツマリ	詰まり
アトツギ	跡継ぎ
ウチワ	団扇
アオグ	扇ぐ
ニクラシイ	憎らしい
フウド	風土
ハリガミ	張り紙
オシヨセル	押し寄せる
ケンギョウ	兼業
キョウザイ	教材
ボコク	母国
チクショウ	畜生
ソンゾク	存続
ミナレル	見慣れる
センスイ	潜水
アンジル	案じる
ネボウ	寝坊
カフン	花粉
モフク	喪服
タンドク	単独
タンスイ	淡水
チュウフク	中腹
チュウショウ	抽象
レンメイ	連盟
コウザ	口座
セイショウネン	青少年
ズカン	図鑑
タンパクシツ	蛋白質
シュゲイ	手芸
リコン	利根
セキム	責務
アキレル	呆れる
モチキリ	持ち切り
タイカ	退化
テンカイ	転回
ケンシュウ	研修
チョウダイ	頂戴
ユウボク	遊牧
ゼイタク	贅沢
コジン	故人
カイカン	会館
シキュウ	支給
ハイキュウ	配給
ナニナニ	何々
カイゴ	介護
カイニュウ	介入
タイ	他意
シュウギョウ	就業
ネツリョウ	熱量
ソウコウ	走行
ゼッパン	絶版
キョウメイ	共鳴
グタイ	具体
イタズラ	悪戯
ドウヨウ	童謡
イギ	異議
イロン	異論
キン	菌
キッサ	喫茶
ミマン	未満
コッケイ	滑稽
ツモリ	積もり
ヒラガナ	平仮名
コウザ	講座
ジン	陣
チョクリュウ	直流
ヒトイキ	一息
ソウビ	装備
キョウジル	興じる
ゲキダン	劇団
シャレ	洒落
コウソウ	抗争
ツツシム	謹む
ハアク	把握
シトヤカ	淑やか
ヨビトメル	呼び止める
シュウエキ	収益
ジュウギョウ	従業
ツウセツ	痛切
ソレ	其れ
コウシンリョウ	香辛料
カクシュウ	隔週
ギャクテン	逆転
カフンショウ	花粉症
コクオウ	国王
オウ	王
テンカン	転換
チョウタン	長短
ジコクヒョウ	時刻表
カワク	渇く
ジョジョ	徐々
ハイゴ	背後
ミンシュク	民宿
イクラ	幾ら
イキナリ	行き成り
ノウヤク	農薬
ナシ	無し
タバコ	煙草
ナラウ	倣う
タマラナイ	堪らない
コウシュウ	講習
ソウダイ	壮大
ドウリョウ	同僚
シカク	視覚
シアガル	仕上がる
ヨウエキ	溶液
サオ	竿
コウサク	耕作
ガクゲイ	学芸
ゲイ	芸
シッチョウ	失調
ユウエツ	優越
フマエル	踏まえる
ナイシ	乃至
ビン	便
カヨウ	歌謡
フッコウ	復興
バクハ	爆破
ボッシュウ	没収
ジキ	磁気
ザイゲン	財源
オオスジ	大筋
ノドカ	長閑
フリョク	浮力
ホンノ	本の
スデニ	既に
トモニ	共に
ナオ	尚
ゼヒ	是非
アタリ	辺り
ミョウ	妙
キッカケ	切っ掛け
キレイ	奇麗
ナル	生る
ナンデモ	何でも
イヤシイ	卑しい
ナイラン	内乱
カクサン	拡散
ケイベツ	軽蔑
トウソツ	統率
ツカサドル	司る
カタワラ	傍ら
ヨソク	予測
フタ	蓋
コノゴロ	この頃
チカゴロ	近頃
トシゴロ	年頃
ツギメ	継ぎ目
フリダス	降り出す
ニョウ	尿
キョウサク	凶作
ギワク	疑惑
トマドイ	戸惑い
シュウガク	修学
ガッキュウ	学級
キュウ	級
チカン	痴漢
ケイゲン	軽減
ネンカン	年鑑
クライ	暗い
ムチャ	無茶
モラウ	貰う
シレイ	指令
フロシキ	風呂敷
コウボ	公募
ボキン	募金
ウラ	裏
ショウキョ	消去
ワク	湧く
フントウ	奮闘
シコウ	志向
シボウ	志望
キサイ	記載
タビ	足袋
コレ	此れ
ショウゴウ	照合
カビ	華美
マク	幕
ソッケナイ	素っ気ない
コウキョ	皇居
セイコウ	精巧
エンリョナク	遠慮なく
ゴク	語句
キュウリョウ	丘陵
テヌグイ	手拭い
サイタク	採択
チョ	著
ザイコ	在庫
テガケル	手掛ける
スナワチ	即ち
タクサン	沢山
イキガイ	生き甲斐
ダンリョク	弾力
マク	膜
コウセキ	功績
コンテイ	根底
キリ	桐
センキョウ	宣教
コガス	焦がす
ハキケ	吐き気
ドワスレ	度忘れ
ジバン	地盤
トガル	尖る
ジコウ	事項
ケンメイ	懸命
イドム	挑む
カイテイ	改訂
キュウジ	給仕
オネガイシマス	お願いします
カンケツ	簡潔
ハレル	腫れる
フゾク	附属
ケイキ	契機
トジル	綴じる
サシコム	差し込む
ハイキ	廃棄
マサニ	正に
ツウカン	痛感
イゾン	依存
カンラン	観覧
ヨウブン	養分
アンショウバンゴウ	暗証番号
オカゲサマデ	お蔭様で
ケッソク	結束
マユゲ	眉毛
ゲキゾウ	激増
カリ	狩り
ハッシャ	発射
ジンソク	迅速
ウズ	渦
オヒル	お昼
キネンヒ	記念碑
クビカザリ	首飾り
マキ	巻
ツクロウ	繕う
カクジュウ	拡充
ドコ	何処
ヘコム	凹む
コウケン	貢献
シカ	鹿
イキグルシイ	息苦しい
ザヒョウ	座標
トオマワリ	遠回り
ニオウ	匂う
カイジュウ	怪獣
カンレキ	還暦
オオガラ	大柄
コウチ	耕地
ハシゴ	梯子
ハチミツ	蜂蜜
チクサン	畜産
カンソ	簡素
ジュリツ	樹立
ケンヨウ	兼用
ヒナマツリ	雛祭
イチリツ	一律
リジュン	利潤
イタッテ	至って
シュウ	宗
フミコム	踏み込む
コウジョ	控除
クグル	潜る
タイマン	怠慢
アコガレル	憧れる
ギジドウ	議事堂
ヌラス	濡らす
ジュウ	銃
ザツボク	雑木
ヒルメシ	昼飯
カイガラ	貝殻
イタク	委託
ホロボス	滅ぼす
カンガイ	感慨
イッカツ	一括
シカケ	仕掛け
ゲンテン	原典
ヘダタル	隔たる
セイテキ	静的
キョウジュ	享受
ウチワケ	内訳
カタヅケ	片付け
シバ	芝
キリカエル	切り替える
アツカイ	扱い
ショム	庶務
カナウ	叶う
カナエル	叶える
モノスゴイ	物凄い
カンセイ	歓声
タタク	叩く
カンコク	勧告
クビワ	首輪
オウシン	往診
コウ	甲
カイテキ	快適
キョウド	郷土
トドコオル	滞る
サワヤカ	爽やか
ヘンセン	変遷
サエル	冴える
クラブ	倶楽部
ユガム	歪む
キョウコウ	強硬
イリョク	威力
コグ	漕ぐ
フゴウ	富豪
ヨキョウ	余興
カイラン	回覧
サンプク	山腹
ショウ	症
ラクノウ	酪農
レイテン	零点
ホウケン	封建
マク	蒔く
ジョウカ	城下
カッコ	括弧
ケル	蹴る
スイハンキ	炊飯器
スリ	刷り
ムク	剥く
ハゲル	剥げる
ハグ	剥ぐ
カシコマリマシタ	畏まりました
オツ	乙
アサ	麻
ハカル	諮る
アキ	明き
カム	噛む
ナデル	撫でる
タダシ	但し
アフレル	溢れる
ゴバン	碁盤
ナヤマシイ	悩ましい
ソル	剃る
ショジュン	初旬
ソロウ	揃う
ソロエル	揃える
ソクザニ	即座に
ジャガイモ	ジャガ芋
フク	拭く
シンテイ	進呈
シノグ	凌ぐ
ホッペタ	頬っぺた
カンコウ	慣行
テノヒラ	手の平
シャレル	洒落る
モウカル	儲かる
モウケル	儲ける
チョウシンキ	聴診器
ウタ	詩
キュウデン	宮殿
ノウド	濃度
タメル	溜める
タマル	溜まる
チャノユ	茶の湯
アキラメル	諦める
イッセイ	一斉
ノノシル	罵る
ケイバツ	刑罰
ゼツメツ	絶滅
オヨギ	泳ぎ
ツルス	吊るす
ツル	吊る
センニュウ	潜入
カグ	嗅ぐ
コウショウ	高尚
ワビ	詫び
ワビル	詫びる
ゴゾンジ	ご存知
ワラ	藁
コジ	孤児
タツ	発つ
ハイシャク	拝借
テッコウ	鉄鋼
タルム	弛む
ノセル	載せる
イカニモ	如何にも
イケナイ	行けない
オフクロ	お袋
オシャベリ	お喋り
カモシレナイ	かも知れない
クッツク	くっ付く
コダワル	拘わる
コレカラ	此れから
シキリニ	頻りに
ズラス	滑らす
ソシテ	然して
ソノウチ	その内
ソレカラ	其れから
ソレデ	其れで
ソレトモ	其れ共
ソレニ	其れに
ダラシナイ	だらし無い
ダルイ	怠い
トコロガ	所が
トンデモナイ	とんでも無い
ナゼナラ	何故なら
ブツカル	打つかる
マゴツク	間誤付く
モシ	若し
モシカシタラ	若しかしたら
モシカスルト	若しかすると
ヤッパリ	矢っ張り
ヤル	遣る
ガラス	硝子
コンクリート	混凝土
ダース	打
バネ	発条
ヨル	因る
ヌルイ	温い
クダラナイ	下らない
イツマデモ	何時までも
イツモ	何時も
ドコカ	何処か
ヤカマシイ	喧しい
アエテ	敢えて
マルデ	丸で
ウレシイ	嬉しい
キザ	気障
アナタ	貴方
ヨロシイ	宜しい
ヨロシク	宜しく
マシテ	況して
アクビ	欠伸
ミットモナイ	見っともない
クレル	呉れる
クレグレモ	呉れ呉れも
ゴメン	御免
オメデトウ	お目出度う
ゴマカス	誤魔化す
ココ	此処
コンニチハ	今日は
コンバンハ	今晩は
サヨウナラ	左様なら
スミマセン	済みません
シマウ	仕舞う
コトニヨル	事による
ウヌボレ	自惚れ
シカル	叱る
トックニ	疾っくに
モシクハ	若しくは
イトコ	従兄弟
トコロデ	所で
シッポ	尻尾
マサカ	真逆
ツイニ	遂に
スゴイ	凄い
ナルベク	成るべく
ナルホド	成程
アイニク	生憎
マズ	先ず
チギル	千切る
ヨウヤク	漸く
フサワシイ	相応しい
ソレデハ	其れでは
ソレデモ	其れでも
ソコデ	其処で
ワザト	態と
イタダキマス	頂きます
オトナシイ	大人しい
チョウド	丁度
シャベル	喋る
チョウ	超
スグ	直ぐ
カミソリ	剃刀
トウトウ	到頭
トン	屯
ドウシテ	如何して
ドウシテモ	如何しても
イカニ	如何に
ウルサイ	煩い
カブセル	被せる
オイシイ	美味しい
フト	不図
マズイ	不味い
シカシ	然し
シカモ	然も
オヨソ	凡そ
マダ	未だ
ムヤミニ	無闇に
ムチャクチャ	無茶苦茶
メチャクチャ	目茶苦茶
タヤスイ	容易い
サスガ	流石
コボレル	零れる
イツデモ	何時でも
コノ	此の
アラユル	有らゆる
アルイハ	或いは
オカズ	御数
オヤツ	お八つ
カナリ	可也
シッカリ	確り
スガスガシイ	清々しい
セッカク	折角
ノンキ	暢気
バラマク	散蒔く
ヒドイ	酷い
マスマス	益々
ワザワザ	態々
メデタイ	目出度い
セイ	所為
ツケル	点ける
アレコレ	彼此
オハヨウ	お早う
ソウシテ	然うして
タマニ	偶に
ハク	泊
ヒッコシ	引越し
ニブル	鈍る
ハジラウ	恥じらう
ソシ	阻止
ナガイ	永い
タンソ	炭素
コナゴナ	粉々
ヒザシ	陽射
セイジュン	清純
ゼン	膳
アマクチ	甘口
サンガク	山岳
ガイリャク	概略
ショクリョウ	食糧
ヨウガン	溶岩
アンザン	暗算
スエツケル	据え付ける
ウリアゲ	売上
タケ	丈
タンコウ	炭鉱
ヨロコブ	慶ぶ
ツケル	浸ける
カンベン	勘弁
カンヨウ	慣用
ハツミミ	初耳
キュウボウ	窮乏
ジョウ	嬢
キレイ	綺麗
イキサツ	経緯
ロウスイ	老衰
ヒロウ	披露
カタコト	片言
アル	或る
ニクイ	憎い
クヤム	悔やむ
ドヒョウ	土俵
ホゲイ	捕鯨
メス	召す
セン	栓
ゴランニナル	ご覧になる
ハサマル	挟まる
スマス	澄ます
カワイソウ	可哀想
ジョウキ	蒸気
ミツ	蜜
ハナミズ	鼻水
セリフ	台詞
カンソウキ	乾燥機
ショウユ	しょう油
キフク	起伏
カシワ	柏
ウケモチ	受持ち
ガイセツ	概説
モト	基
メモリ	目盛
カユ	粥
イチ	位地
マコトニ	真に
ヨイ	好い
ボウヤ	坊や
ナカミ	中味
オセジ	御世辞
タエル	断える
ナマヌルイ	生温い
メザマシ	目覚し
ジキ	磁器
ツカイ	遣い
スム	清む
メザマシイ	目覚しい
ナサケナイ	情無い
トゲ	刺
ソッチョク	卒直
カレラ	彼等
カシ	菓子
シハライ	支払
ソウ	僧
タマ	弾
トジマリ	戸締り
フルマウ	振舞う
ヨク	良く
ウタ	歌(う)
トオ	通(る)
ハズ	外(す)
ハナシア	話し合(う)
ウケト	受け取(る)
アラタ	改(める)
サダ	定(める)
マワ	回(す)
トイア	問い合(わせる)
デア	出会(う)
ナリタ	成り立(つ)
ウゴ	動(かす)
オモイダ	思い出(す)
ミナオ	見直(す)
タモ	保(つ)
クダ	下(る)
アラソ	争(う)
ウミダ	生み出(す)
カゾ	数(える)
ウリダ	売り出(す)
シリア	知り合(う)
ヒキア	引き上(げる)
ヒキサ	引き下(げる)
ウタガ	疑(う)
サダ	定(まる)
モチ	用(いる)
カマ	構(う)
クワ	加(わる)
ハズ	外(れる)
ハナ	話(す)
ハジ	始(める)
シタ	親(しむ)
クバ	配(る)
ホウ	報(じる)
ヒキト	引き取(る)
クワ	加(える)
トウ	投(じる)
スス	進(む)
ワタ	渡(す)
ノゾ	望(む)
タノ	楽(しむ)
フカ	深(める)
ウツ	移(す)
ワカ	別(れる)
エン	演(ずる)
ヒキダ	引き出(す)
ノコ	残(る)
ハナ	放(つ)
ミハナ	見放(す)
ハカ	図(る)
タメ	試(す)
イソ	急(ぐ)
ミキワ	見極(める)
コノ	好(む)
ホドコ	施(す)
トビダ	飛び出(す)
フカ	深(まる)
オサ	収(まる)
オサ	収(める)
マチウ	待ち受(ける)
ウツ	写(る)
ヒッパ	引っ張(る)
ソナ	備(わる)
ヤクニタ	役に立(つ)
ソダ	育(つ)
ヤブ	破(る)
マチカマ	待ち構(える)
モウシア	申し上(げる)
トリケ	取り消(す)
ソソ	注(ぐ)
オイダ	追い出(す)
ノボ	登(る)
クミコ	組み込(む)
オチコ	落ち込(む)
モヨオ	催(す)
メイ	命(じる)
フリカエ	振り返(る)
モウ	申(す)
ウツ	写(す)
ツラ	連(ねる)
マチノゾ	待ち望(む)
クル	苦(しめる)
アマ	余(る)
ハイ	入(る)
マナ	学(ぶ)
ネラ	狙(う)
ヨビダ	呼び出(す)
ツク	作(る)
ソナ	備(える)
ツノ	募(る)
キン	禁(じる)
ナオ	治(る)
ヨロコ	喜(ぶ)
ヨロコ	喜(ばす)
ヨビカ	呼び掛(ける)
シメキ	締め切(る)
スク	救(う)
ミダ	乱(れる)
ヨソオ	装(う)
ソコ	損(なう)
タヨ	頼(る)
ウラギ	裏切(る)
ミア	見合(わせる)
キザ	刻(む)
ムカ	迎(える)
トリコ	取り込(む)
ウチコ	打ち込(む)
コワ	壊(す)
ヒキツ	引き継(ぐ)
タタカ	闘(う)
ロン	論(じる)
ショウ	生(じる)
オコナ	行(う)
タチヨ	立ち寄(る)
クイコ	食い込(む)
コワ	壊(れる)
オソ	恐(れる)
ノリカ	乗り換(える)
マニア	間に合(う)
オウ	応(ずる)
マニア	間に合(わせる)
アバ	暴(れる)
ミノ	実(る)
ドウ	動(じる)
アラワ	表(す)
ロン	論(ずる)
エラ	選(ぶ)
カン	感(ずる)
ミア	見上(げる)
トオリス	通り過(ぎる)
ウチア	打ち上(げる)
タカ	高(まる)
タカ	高(める)
ハジ	始(まる)
フンバ	踏ん張(る)
ツクリア	作り上(げる)
カヨ	通(う)
タオ	倒(す)
ムク	報(いる)
ヒッコ	引っ越(す)
キド	気取(る)
ノリコ	乗り越(える)
ヤワ	和(らぐ)
ヤワ	和(らげる)
マジ	交(わる)
フセ	防(ぐ)
ノボ	上(る)
ツト	務(める)
ハカ	測(る)
ツヨ	強(める)
ハラ	払(う)
ミチガ	見違(える)
マド	惑(わす)
オモ	思(う)
アタ	与(える)
タビダ	旅立(つ)
ウケイ	受け入(れる)
カク	隠(す)
エン	演(じる)
ナガビ	長引(く)
トリダ	取り出(す)
ナヅ	名付(ける)
ヒキオ	引き起(こす)
シル	記(す)
メダ	目立(つ)
コロ	転(がす)
コロ	転(がる)
クイサ	食い下(がる)
アツカ	扱(う)
ムス	結(ぶ)
デア	出合(う)
ココロ	試(みる)
チガ	違(う)
サワ	騒(ぐ)
ココロエ	心得(る)
ヨリカ	寄り掛(かる)
キワダ	際立(つ)
アラワ	現(す)
マサ	勝(る)
ヒロ	広(める)
アタタ	温(まる)
カサ	重(ねる)
カンガ	考(える)
タタカ	戦(う)
アツ	集(まる)
アツ	集(める)
ワラ	笑(う)
モト	基(づく)
ツカ	使(う)
イタ	致(す)
ウチケ	打ち消(す)
モチナオ	持ち直(す)
クダ	下(す)
ミト	認(める)
タト	例(える)
オカ	侵(す)
マイ	参(る)
ウツ	映(る)
ノガ	逃(れる)
カン	感(じる)
タチア	立ち上(がる)
シメ	示(す)
リキ	力(む)
ヒロ	広(がる)
モド	戻(す)
オシ	教(える)
カザ	飾(る)
ツイ	費(やす)
トリハズ	取り外(す)
キヅ	気付(く)
タシ	確(かめる)
クイト	食い止(める)
ハコ	運(ぶ)
アラワ	現(れる)
アラ	現(われる)
シラ	調(べる)
ヒロ	広(まる)
ヒロ	広(げる)
シイ	仕入(れる)
オウ	応(じる)
アジ	味(わう)
オモ	重(んじる)
マチガ	間違(える)
マチガ	間違(う)
ミワタ	見渡(す)
タチナオ	立ち直(る)
ミオ	見下(ろす)
ニカヨ	似通(う)
デキア	出来上(がる)
トリク	取り組(む)
シリア	知合(う)
ナガ	流(す)
アズ	預(ける)
シン	信(じる)
ナヤ	悩(む)
カエ	返(す)
キニイ	気に入(る)
ホウ	放(る)
フク	含(む)
オドロ	驚(かす)
ヒキア	引上(げる)
ヒキウ	引き受(ける)
ヒキサ	引下(げる)
トリア	取り上(げる)
ナゴ	和(む)
カタ	語(る)
モノガタ	物語(る)
イトナ	営(む)
トトノ	整(う)
オモイア	思い上(がる)
ヒキ	率(いる)
ウケト	受け止(める)
ミオク	見送(る)
オク	送(る)
ワリダ	割り出(す)
モウ	設(ける)
ナオ	直(す)
タク	託(す)
マワ	回(る)
ヤト	雇(う)
クラ	比(べる)
アズ	預(かる)
ツヨ	強(まる)
ソナ	供(える)
コトワ	断(る)
シボ	絞(る)
オソ	教(わる)
ヒキト	引取(る)
フク	膨(れる)
ウケツ	受け付(ける)
ミツ	見付(かる)
ヒカ	光(る)
コロ	転(ぶ)
ツウ	通(じる)
キラ	嫌(う)
スワ	座(る)
カナ	悲(しむ)
タテナオ	立て直(す)
アラタ	改(まる)
タズ	訪(ねる)
サシア	差し上(げる)
ハバ	阻(む)
ノコ	残(す)
オサ	治(まる)
オサ	治(める)
タチド	立ち止(まる)
カエ	反(す)
ヒキダ	引出(す)
トリツ	取り次(ぐ)
タス	助(ける)
オモイキ	思い切(る)
ジョウ	乗(じる)
ハヤ	早(める)
ハカ	計(る)
カギ	限(る)
ツラ	連(なる)
イイダ	言い出(す)
ミス	見過(ごす)
アオ	青(ざめる)
ウチア	打ち明(ける)
ツタ	伝(わる)
タダ	正(す)
クイチガ	食い違(う)
カキナオ	書き直(す)
トビオ	飛び降(りる)
タス	助(かる)
サシダ	差し出(す)
アラワ	表(れる)
ハヤ	早(まる)
オオ	覆(う)
クミタ	組み立(てる)
メイ	命(ずる)
チカヅ	近付(ける)
ウシナ	失(う)
ゾン	存(じる)
クワダ	企(てる)
ハゲ	励(ます)
サガ	探(す)
マモ	守(る)
モウシデ	申し出(る)
カサ	重(なる)
オヨ	及(ぼす)
オモイナオ	思い直(す)
サシツカ	差し支(える)
ナラ	並(ぶ)
サケ	叫(ぶ)
アラ	表(わす)
ウツ	映(す)
ヒキハナ	引き離(す)
オド	脅(す)
オボ	覚(える)
アラ	現(わす)
オイツ	追い付(く)
モリア	盛り上(げる)
ヤクダ	役立(つ)
ワリア	割り当(てる)
フク	膨(らむ)
ツッパ	突っ張(る)
アユミヨ	歩み寄(る)
ヨコギ	横切(る)
ウケモ	受け持(つ)
アラ	洗(う)
ウラナ	占(う)
イキワタ	行き渡(る)
ホコ	誇(る)
ウツ	移(る)
ホウム	葬(る)
メザ	目指(す)
イワ	祝(う)
オヨ	及(ぶ)
カツ	担(ぐ)
ツケクワ	付け加(える)
オトズ	訪(れる)
ウッタ	訴(える)
ハナ	離(れる)
オギナ	補(う)
トダ	途絶(える)
メグリア	巡り会(う)
ハナ	放(す)
オシツ	押し付(ける)
マチア	待ち合(わせる)
ナオ	直(る)
カエ	帰(る)
ヒソ	潜(む)
トオ	通(す)
コロ	殺(す)
シン	信(ずる)
ナオ	治(す)
モリア	盛り上(がる)
ガンバ	頑張(る)
ツキア	付き合(う)
ニナ	担(う)
ヒキツ	引き付(ける)
クギ	区切(る)
ツッコ	突っ込(む)
ノリマワ	乗り回(す)
ミクラ	見比(べる)
ナガ	流(れる)
サズ	授(ける)
シア	仕上(げる)
サガ	捜(す)
ワズラ	患(う)
ワタ	渡(る)
ハシ	走(る)
ハズ	弾(む)
ツカ	捕(まえる)
キソ	競(う)
ヤス	休(む)
ハカ	量(る)
ツキア	突き当(たる)
トリア	取上(げる)
ハナシコ	話し込(む)
ヨコ	横(たわる)
ミマ	見舞(う)
キン	禁(ずる)
モチナオ	持直(す)
ナグ	殴(る)
キメツ	決め付(ける)
ヒキシ	引き締(める)
モチコ	持ち込(む)
オイコ	追い込(む)
ミハ	見張(る)
ツク	造(る)
ミカギ	見限(る)
ヘダ	隔(てる)
メザ	目覚(める)
テツダ	手伝(う)
タダヨ	漂(う)
ヒキウ	引受(ける)
カイシ	買い占(める)
ニア	似合(う)
トリヨ	取り寄(せる)
ヒキオコ	引き起(す)
ワリキ	割り切(る)
オキア	起き上(がる)
クズ	崩(す)
アマ	余(す)
カブ	被(る)
ユル	緩(む)
タノ	頼(む)
シタ	仕立(てる)
カエ	反(る)
アソ	遊(ぶ)
マル	丸(める)
マヨ	迷(う)
ユル	許(す)
ウチケ	打消(す)
ミウシナ	見失(う)
ヌケダ	抜け出(す)
クイト	食止(める)
カラ	絡(む)
ヨゴ	汚(れる)
ヨワ	弱(まる)
ヨワ	弱(める)
キワ	極(まる)
ウケツ	受け継(ぐ)
ノゾ	臨(む)
チカヨ	近寄(る)
ツト	努(める)
カタ	固(める)
ヒエコ	冷え込(む)
ノット	乗っ取(る)
ノリダ	乗り出(す)
キカ	着替(える)
タチサ	立ち去(る)
チカ	近(づく)
カコ	囲(む)
セオ	背負(う)
ヒキシ	引き締(まる)
ミイダ	見出(す)
カエリ	省(みる)
セマ	迫(る)
ハリダ	張り出(す)
ハリキ	張り切(る)
クズ	崩(れる)
カエ	帰(す)
ツグナ	償(う)
ショウ	生(ずる)
ソナ	具(わる)
ノボ	上(せる)
コバ	拒(む)
シズ	静(まる)
ツタ	伝(う)
タオ	倒(れる)
サガシマワ	捜し回(る)
ミオ	見落(とす)
チカヅ	近付(く)
ミツ	見付(ける)
フミキ	踏み切(る)
ウケタマワ	承(る)
モウシコ	申し込(む)
トビコ	飛び込(む)
コト	異(なる)
ニゲダ	逃げ出(す)
ヨリワ	選り分(ける)
ヒラ	開(く)
オコ	興(す)
トオ	遠(ざかる)
シハラ	支払(う)
ケズ	削(る)
シバ	縛(る)
ヒキ	引(ずる)
ワリダ	割出(す)
ネガ	願(う)
クイチガ	食違(う)
キズツ	傷付(ける)
カカ	関(わる)
ウナガ	促(す)
ウゴ	動(く)
ツツシ	慎(む)
フト	太(る)
オサ	修(める)
ツカ	捕(まる)
アユ	歩(む)
ミマモ	見守(る)
イイアラワ	言い表(す)
イイアラ	言い表(わす)
チヂ	縮(む)
オサ	抑(える)
カオ	香(る)
キワ	極(める)
ウラガエ	裏返(す)
ワリア	割当(てる)
ネギ	値切(る)
ブラサ	ぶら下(がる)
ブラサ	ぶら下(げる)
オモイツ	思い付(く)
ココロザ	志(す)
オカ	犯(す)
デカ	出掛(ける)
ヒキカエ	引き返(す)
イキカエ	生き返(る)
カエ	返(る)
ヒキツ	引継(ぐ)
モテナ	持て成(す)
オチツ	落ち着(く)
カカ	抱(える)
クリカエ	繰り返(す)
トリシ	取り締(まる)
トリイ	取り入(れる)
シタガ	従(う)
フルマ	振る舞(う)
ナラ	習(う)
オモ	思(いとどまる)
オモイア	思い当(たる)
ソコナ	損(う)
ツヅ	続(く)
ツヅ	続(ける)
スス	進(める)
トギ	途切(れる)
ヒキツ	引付(ける)
クル	苦(しむ)
カカ	掲(げる)
ヒッコ	引っ込(む)
ノボ	昇(る)
トラ	捕(える)
サシノ	差し伸(べる)
ササ	支(える)
トモ	点(す)
カキト	書き取(る)
イキワタ	行渡(る)
ワカ	解(る)
ノリマワ	乗回(す)
サワ	触(る)
ハナ	離(す)
トビオ	飛び下(りる)
ウズ	埋(まる)
ユダ	委(ねる)
トトノ	調(う)
オモ	重(んずる)
マキコ	巻き込(む)
ワカ	判(る)
ノリコ	乗り込(む)
トマド	戸惑(う)
アヤマ	謝(る)
クミア	組み合(わせる)
クル	包(む)
ヒキハナ	引離(す)
トリカエ	取り返(す)
トリモド	取り戻(す)
マカ	任(せる)
モト	求(める)
ウバ	奪(う)
ヤク	訳(す)
ミダ	乱(す)
カカ	係(わる)
ウス	薄(める)
ハライコ	払い込(む)
ウチア	打ち合(わせる)
サソ	誘(う)
サカ	栄(える)
タット	貴(ぶ)
ヤリナオ	やり直(す)
ヒカ	控(える)
オモイコ	思い込(む)
ツケコ	付け込(む)
オク	贈(る)
ヒッカ	引っ掛(かる)
ニギ	握(る)
トド	留(める)
イイカエ	言い返(す)
ヤシナ	養(う)
カシダ	貸し出(す)
アワ	慌(てる)
ナガ	眺(める)
ハヤ	流行(る)
サガシマワ	探し回(る)
ミナラ	見習(う)
ココロ	心(がける)
オド	脅(かす)
クチ	口(ごもる)
ウス	薄(まる)
ヤリス	やり過(ごす)
メグ	巡(る)
ハナ	放(れる)
アヤツ	操(る)
キリス	切り捨(てる)
タズサ	携(える)
ミツ	見詰(める)
サバ	裁(く)
ウリコ	売り込(む)
ワリコ	割り込(む)
ヌス	盗(む)
スイコ	吸い込(む)
サグ	探(る)
サカ	逆(らう)
ヒキト	引き止(める)
ヒキト	引止(める)
トモナ	伴(う)
イイカ	言い換(える)
カマ	構(える)
ワリビ	割り引(く)
ワリビ	割引(く)
キカザ	着飾(る)
チカ	近(づける)
マギ	紛(れる)
イタ	傷(む)
クッツ	くっ付(ける)
ブツ	打付(ける)
オイコ	追い越(す)
キヲツ	気を付(ける)
コトヅ	言付(ける)
ヒキノ	引き延(ばす)
ヒッツ	引っ付(く)
ヤッツ	やっ付(ける)
ウリキ	売り切(れる)
チギ	千切(れる)
ハヤ	速(める)
ハミデ	食み出(る)
ハミダ	食み出(す)
トリアツカ	取り扱(う)
ソコ	損(ねる)
スグ	優(れる)
イマシ	戒(める)
ムラ	群(がる)
ツケタ	付け足(す)
ハナシコ	話込(む)
ドナ	怒鳴(る)
ミチビ	導(く)
ソナエツ	備え付(ける)
マカナ	賄(う)
ユズ	譲(る)
ハナ	話(しかける)
スキトオ	透き通(る)
スベ	滑(る)
ミトド	見届(ける)
ヒキモド	引き戻(す)
モド	戻(る)
アワ	併(せる)
ソダ	育(てる)
ハグク	育(む)
カタ	固(まる)
ジョウ	乗(ずる)
イタ	痛(む)
ソナ	具(える)
フレア	触れ合(う)
オソ	襲(う)
オサ	納(まる)
オサ	納(める)
ツカ	疲(れる)
カコ	囲(う)
ホロ	滅(びる)
アセ	焦(る)
イタワ	労(る)
カタヅ	片付(ける)
ヒッカ	引っ掛(ける)
サシカ	差し掛(かる)
ココロガ	心掛(ける)
トラ	捕(われる)
ミノガ	見逃(す)
ノリオク	乗り遅(れる)
オク	遅(れる)
ツタ	伝(える)
ハタラ	働(く)
オチア	落ち合(う)
ヒキシ	引締(める)
アイテド	相手取(る)
タチノ	立ち退(く)
ナゾラ	準(える)
ニギリシ	握り締(める)
オチイ	陥(る)
ハゲ	励(む)
ヨワ	弱(る)
チヂ	縮(まる)
ミア	見当(たる)
ユビサ	指差(す)
タテカ	立て替(える)
トビア	飛び上(がる)
オトロ	衰(える)
カエリ	顧(みる)
コオ	凍(る)
ヒキカエ	引返(す)
イキカエ	生返(る)
ハライモド	払い戻(す)
フク	含(める)
コマ	困(る)
オコ	怒(る)
オヨ	泳(ぐ)
タズ	尋(ねる)
トトノ	整(える)
シブ	渋(る)
ミス	見捨(てる)
オカ	冒(す)
アラ	荒(す)
クサ	腐(る)
ヒビ	響(く)
トリカ	取り掛(かる)
フキコ	吹き込(む)
ヤブ	敗(れる)
イタ	至(る)
ネダ	強請(る)
ヨゴ	汚(す)
タクワ	蓄(える)
ウチダ	打ち出(す)
マル	丸(まる)
タバ	束(ねる)
ハバタ	羽撃(く)
ハブ	省(く)
クル	狂(う)
コワ	怖(がる)
カタヅ	片付(く)
トリカ	取り替(える)
アル	歩(く)
オモ	思(いつく)
トナリア	隣り合(う)
フキダ	吹き出(す)
カタヨ	偏(る)
マカ	任(す)
アマ	甘(える)
アヤマ	誤(る)
オモテダ	表立(つ)
マジ	交(える)
ツト	勤(める)
ヒキノ	引き伸(ばす)
ヒキノバ	引き伸(す)
ヒキノ	引伸(ばす)
ヒキノバ	引伸(す)
コシカ	腰掛(ける)
オリカエ	折り返(す)
ダマ	黙(る)
ヤブ	破(れる)
トリノゾ	取り除(く)
ノゾ	除(く)
ヤス	安(らぐ)
ヒキノバ	引き延(す)
ヒキノ	引延(ばす)
ヒキノバ	引延(す)
ナシト	成し遂(げる)
マツ	祭(る)
ナラ	並(べる)
シタガ	従(える)
シゲ	茂(る)
フリム	振り向(く)
ワキマ	弁(える)
ヒタ	浸(る)
テン	転(じる)
イバ	威張(る)
イヤ	嫌(がる)
サシシメ	指し示(す)
カワイ	可愛(がる)
ヤス	休(める)
タズサ	携(わる)
オモ	重(る)
スス	勧(める)
オト	劣(る)
ハカ	謀(る)
ウタ	謡(う)
ツキサ	突き刺(す)
ミイ	見入(る)
イチヅ	位置付(ける)
ヨリアツ	寄り集(まる)
チカヨ	近寄(せる)
マルメコ	丸め込(む)
タテコ	立て込(む)
ノボ	逆上(せる)
カセ	稼(ぐ)
ヒキモド	引戻(す)
ネム	眠(る)
マキコ	巻込(む)
シズ	沈(む)
ソム	背(く)
ヒッカカ	引っ掛(る)
ハナシカ	話し掛(ける)
トリカ	取り換(える)
モチダ	持ち出(す)
トリキ	取り決(める)
アマ	甘(やかす)
ヒキヌ	引き抜(く)
ヒキヌ	引抜(く)
オイヌ	追い抜(く)
ツキヌ	突き抜(ける)
トリノコ	取り残(す)
デム	出向(く)
ネバ	粘(る)
イキス	行き過(ぎる)
ミウ	見受(ける)
ツク	創(る)
サワ	障(る)
フル	奮(う)
カタヨ	片寄(る)
ムス	結(びつく)
カキア	書き上(げる)
セバ	狭(める)
ウチキ	打ち切(る)
リャク	略(す)
オイカ	追い掛(ける)
ニコ	煮込(む)
ヒルガエ	翻(す)
チカ	誓(う)
タガヤ	耕(す)
オロ	卸(す)
アタタ	暖(まる)
ウツシダ	映し出(す)
ミソコ	見損(なう)
セバ	狭(まる)
キズ	築(く)
ミクダ	見下(す)
オコタ	怠(る)
オク	遅(らす)
ナゲダ	投げ出(す)
アタタ	温(める)
マネ	招(く)
ノミコ	飲み込(む)
イタ	傷(める)
ヒラキナオ	開き直(る)
アラワ	著(す)
アラ	著(わす)
ヒロ	拾(う)
サマタ	妨(げる)
ツド	集(う)
ヨッパラ	酔っ払(う)
キタ	鍛(える)
オガ	拝(む)
フキダ	噴き出(す)
イダ	抱(く)
ヒックリカエ	引っ繰り返(る)
ヒタ	浸(す)
ミワ	見分(ける)
イイキ	言い切(る)
エガ	描(く)
カワ	乾(かす)
タット	尊(ぶ)
トナリア	隣合(う)
フル	震(える)
テワタ	手渡(す)
ヨコ	寄越(す)
ノリコ	乗り越(す)
ノリコ	乗越(す)
ウレ	憂(える)
チヂ	縮(める)
チヂ	縮(れる)
セリア	競り合(う)
オイア	追い上(げる)
ハタラ	働(かせる)
マネ	真似(る)
オモイオ	思い起(こす)
メグ	恵(む)
シノ	忍(ぶ)
メグ	恵(まれる)
ナノリデ	名乗り出(る)
ナノ	名乗(る)
スス	薦(める)
ユル	緩(める)
カタム	傾(ける)
カタム	傾(く)
カシ	傾(げる)
イキトド	行き届(く)
トド	届(く)
トド	届(ける)
トケコ	溶け込(む)
トリマ	取り巻(く)
アルキマワ	歩き回(る)
ニゴ	濁(る)
コタ	答(える)
キズツ	傷付(く)
ヒキシマ	引き締(る)
ウケオ	請け負(う)
タベス	食べ過(ぎる)
サト	悟(る)
イノ	祈(る)
マギ	紛(らす)
アヤ	危(ぶむ)
ウルオ	潤(う)
デムカ	出迎(える)
ジュン	準(ずる)
トオリカ	通り掛(かる)
シメ	湿(る)
モウシイ	申し入(れる)
メシア	召し上(がる)
ウヤマ	敬(う)
カク	隠(れる)
ウワマワ	上回(る)
ホホエ	微笑(む)
イキゴ	意気込(む)
フリコ	振り込(む)
ワス	忘(れる)
オドロ	驚(く)
デキ	出来(る)
ツラヌ	貫(く)
ナグサ	慰(める)
ホウ	報(ずる)
シタ	慕(う)
サエギ	遮(る)
アオ	仰(ぐ)
コボ	零(す)
ヨミア	読み上(げる)
イタ	炒(める)
カガヤ	輝(く)
シズ	沈(める)
ニク	憎(む)
コゴ	凍(える)
ケム	煙(る)
オド	踊(る)
イイツ	言い付(ける)
オシキ	押し切(る)
イタダ	頂(く)
アタタ	暖(める)
クモ	曇(る)
ナヤ	悩(ます)
オシコ	押し込(む)
テン	転(ずる)
ミハカ	見計(らう)
トリシラ	取り調(べる)
ウラ	恨(む)
カワ	乾(く)
ハサ	挟(む)
ツカ	仕(える)
アザム	欺(く)
ツリア	釣り合(う)
シキ	仕切(る)
トナ	唱(える)
クダ	砕(く)
クダ	砕(ける)
ナゲ	嘆(く)
カス	霞(む)
ミガ	磨(く)
シカ	仕掛(ける)
タタ	畳(む)
ジュン	準(じる)
トリタ	取り立(てる)
ナマ	怠(ける)
クチ	口(ずさむ)
ウカガ	伺(う)
フク	膨(らます)
モチア	持ち上(げる)
ニオ	臭(う)
ササ	捧(げる)
クツガエ	覆(す)
マヌカ	免(れる)
ノガ	逃(す)
スズ	涼(む)
アオ	扇(ぐ)
オシヨ	押し寄(せる)
ミナ	見慣(れる)
アン	案(じる)
アキ	呆(れる)
キョウ	興(じる)
ツツシ	謹(む)
ヨビト	呼び止(める)
カワ	渇(く)
ナラ	倣(う)
シア	仕上(がる)
ツカサド	司(る)
フリダ	降り出(す)
モラ	貰(う)
テガ	手掛(ける)
トガ	尖(る)
イド	挑(む)
サシコ	差し込(む)
ツクロ	繕(う)
ヘコ	凹(む)
ニオ	匂(う)
フミコ	踏み込(む)
クグ	潜(る)
アコガ	憧(れる)
ホロ	滅(ぼす)
ヘダ	隔(たる)
キリカ	切り替(える)
カナ	叶(う)
カナ	叶(える)
タタ	叩(く)
ツブ	瞑(る)
トドコオ	滞(る)
ユガ	歪(む)
ハカ	諮(る)
アフ	溢(れる)
ソロ	揃(う)
ソロ	揃(える)
シノ	凌(ぐ)
シャレ	洒落(る)
モウ	儲(かる)
モウ	儲(ける)
アキラ	諦(める)
ノノシ	罵(る)
タル	弛(む)
クッツ	くっ付(く)
コダ	拘(わる)
マゴツ	間誤付(く)
ゴマカ	誤魔化(す)
シマ	仕舞(う)
コト	事(による)
シカ	叱(る)
チギ	千切(る)
シャベ	喋(る)
カブ	被(せる)
コボ	零(れる)
バラマ	散蒔(く)
ニブ	鈍(る)
スエツ	据え付(ける)
ヨロコ	慶(ぶ)
ゴラン	ご覧(になる)
ハサ	挟(まる)
フルマ	振舞(う)
