ウタウ	歌う
デル	出る
ホウ	方
ジョウズ	上手
ミル	見る
トマル	止まる
ナガイ	長い
ハヤイ	早い
ナナツ	七つ
タブン	多分
ヘタ	下手
クル	来る
オワル	終わる
ツヨイ	強い
ムコウ	向こう
ココノツ	九つ
タツ	立つ
キル	切る
ハナス	話す
スクナイ	少ない
ハジメ	始め
チイサイ	小さい
キル	着る
アカイ	赤い
マイアサ	毎朝
ワタス	渡す
ケサ	今朝
コウサテン	交差点
タノシイ	楽しい
ヒクイ	低い
コウバン	交番
ウワギ	上着
ヒトリ	一人
マツ	待つ
シロイ	白い
フルイ	古い
ヨム	読む
ノル	乗る
ホソイ	細い
アゲル	上げる
ノボル	登る
オモシロイ	面白い
セビロ	背広
クロイ	黒い
アウ	会う
マルイ	丸い
アツイ	熱い
シュクダイ	宿題
ハヤイ	速い
ツクル	作る
ワカル	分かる
ヨウフク	洋服
オモイ	重い
オナジ	同じ
ヒトツ	一つ
クニ	国
トシ	年
オトナ	大人
オオキイ	大きい
フタツ	二つ
フタリ	二人
ダス	出す
ミッツ	三つ
サン	三
トキドキ	時々
カイシャ	会社
ジブン	自分
ウシロ	後ろ
イツツ	五つ
カリル	借りる
ジカン	時間
オソイ	遅い
ヒガシ	東
ミセル	見せる
ヨッツ	四つ
ヨン	四
イマ	今
コンゲツ	今月
コトシ	今年
サライネン	再来年
アタラシイ	新しい
オカネ	お金
イタイ	痛い
キュウ	九
ガクセイ	学生
コドモ	子供
ダイガク	大学
タカイ	高い
アカルイ	明るい
ハジマル	始まる
ゼンブ	全部
ガイコク	外国
ガイコクジン	外国人
カラダ	体
ナル	成る
ホントウ	本当
ハチ	八
ロク	六
ウタ	歌
モンダイ	問題
シメル	締める
ホシイ	欲しい
ライゲツ	来月
ライネン	来年
タベル	食べる
シチ	七
モツ	持つ
トル	取る
ヤマ	山
ハナシ	話
カヨウビ	火曜日
オンナ	女
オンナノコ	女の子
キタ	北
ゴゴ	午後
ゴゼン	午前
ヒャク	百
リッパ	立派
チガウ	違う
ケス	消す
ハレ	晴れ
センゲツ	先月
センセイ	先生
ナマエ	名前
カワ	川
ネル	寝る
サクブン	作文
ゲンキ	元気
チカイ	近い
マルイ	円い
セン	千
ウミ	海
ウル	売る
シル	知る
ミチ	道
ドウブツ	動物
ツカウ	使う
ミズ	水
ハン	半
ハンブン	半分
トケイ	時計
タイヘン	大変
オトコ	男
オトコノコ	男の子
オシエル	教える
アサ	朝
ハジメ	初め
ムラ	村
クダモノ	果物
ニシ	西
ダイドコロ	台所
ヒロイ	広い
チャイロ	茶色
デンキ	電気
デンワ	電話
ユウメイ	有名
クチ	口
デグチ	出口
カエス	返す
スコシ	少し
キイロ	黄色
マチ	町
ガッコウ	学校
リョウリ	料理
オキル	起きる
タテモノ	建物
ヨワイ	弱い
ケッコウ	結構
シンブン	新聞
トル	撮る
キッテ	切手
タイセツ	大切
タベモノ	食べ物
ムズカシイ	難しい
ジテンシャ	自転車
ジドウシャ	自動車
クルマ	車
デンシャ	電車
ミナミ	南
アシ	足
イチバン	一番
スワル	座る
アオイ	青い
オオイ	多い
ケイカン	警官
アル	有る
ビョウイン	病院
ビョウキ	病気
コエ	声
シツモン	質問
ヤオヤ	八百屋
カゾク	家族
ギンコウ	銀行
コウチャ	紅茶
エイガ	映画
リョウシン	両親
コトバ	言葉
ダイスキ	大好き
ヘン	辺
エイゴ	英語
マイニチ	毎日
イシャ	医者
シゴト	仕事
キョネン	去年
イミ	意味
シャシン	写真
ミジカイ	短い
ヤスイ	安い
キエル	消える
ナラブ	並ぶ
ヨコ	横
シロ	白
オボエル	覚える
ヒマ	暇
ヨル	夜
オンガク	音楽
ツメタイ	冷たい
ヨブ	呼ぶ
シヌ	死ぬ
トオカ	十日
テンキ	天気
カイダン	階段
アラウ	洗う
カウ	買う
カイモノ	買い物
ジョウブ	丈夫
ジュギョウ	授業
チズ	地図
コンシュウ	今週
センシュウ	先週
マイシュウ	毎週
ライシュウ	来週
キョウシツ	教室
フトイ	太い
ハシ	橋
ダンダン	段々
カミ	紙
テガミ	手紙
カワイイ	可愛い
オカアサン	お母さん
ハハ	母
クロ	黒
ハナ	花
カエル	帰る
ハル	春
ヒコウキ	飛行機
バンゴウ	番号
アオ	青
スム	住む
オリル	降りる
ミギ	右
エイガカン	映画館
トショカン	図書館
タイシカン	大使館
ヘヤ	部屋
イロ	色
ワタル	渡る
トモダチ	友達
サス	差す
マイバン	毎晩
ハシル	走る
コウエン	公園
ヒダリ	左
ジショ	辞書
マガル	曲がる
アキ	秋
ヤスミ	休み
ヤスム	休む
アツイ	厚い
オトウサン	お父さん
チチ	父
ナツ	夏
ナツヤスミ	夏休み
オジ	伯父
チカテツ	地下鉄
イソガシイ	忙しい
フウトウ	封筒
ヤサシイ	易しい
クスリ	薬
タノム	頼む
アソブ	遊ぶ
エキ	駅
シメル	閉める
ベンリ	便利
トブ	飛ぶ
アブナイ	危ない
リュウガクセイ	留学生
カサ	傘
サンポ	散歩
フツカ	二日
ハツカ	二十日
エンピツ	鉛筆
ミッカ	三日
シズカ	静か
カルイ	軽い
ケッコン	結婚
ハタチ	二十歳
ウマレル	生まれる
イツカ	五日
リョコウ	旅行
イリグチ	入口
レンシュウ	練習
オス	押す
ヨッカ	四日
ハレル	晴れる
ココノカ	九日
イレル	入れる
クツシタ	靴下
カテイ	家庭
ニワ	庭
セイト	生徒
イケ	池
ワカイ	若い
ヨウカ	八日
ヤッツ	八つ
ムイカ	六日
ムッツ	六つ
イロイロ	色々
ザッシ	雑誌
レイゾウコ	冷蔵庫
デカケル	出掛ける
ワルイ	悪い
トオイ	遠い
ナノカ	七日
フク	服
サイフ	財布
ナラウ	習う
ハジメテ	初めて
ユウビンキョク	郵便局
カク	書く
カス	貸す
サキ	先
ユウガタ	夕方
キタナイ	汚い
チカク	近く
アメ	雨
イッショ	一緒
モノ	物
ヒク	引く
ノミモノ	飲み物
トコロ	所
ツギ	次
ニク	肉
ブンショウ	文章
ノム	飲む
ヌグ	脱ぐ
ウスイ	薄い
ショクドウ	食堂
ナクス	無くす
サライゲツ	再来月
カケル	掛ける
オク	置く
スウ	吸う
マッスグ	真っ直ぐ
ダレ	誰
トリ	鳥
チョット	一寸
ブタニク	豚肉
ベンキョウ	勉強
キク	聞く
シマル	閉まる
トナリ	隣
ドレ	何れ
フユ	冬
ハイザラ	灰皿
ヒル	昼
オチャ	お茶
マン	万
ツク	着く
ユキ	雪
マンネンヒツ	万年筆
アビル	浴びる
ツカレル	疲れる
シオ	塩
オトウト	弟
ハガキ	葉書
ハタラク	働く
スキ	好き
ミドリ	緑
イル	要る
マド	窓
ギュウニク	牛肉
キライ	嫌い
イヤ	嫌
コマル	困る
アニ	兄
キョウダイ	兄弟
オヨグ	泳ぐ
カギ	鍵
ニモツ	荷物
ジビキ	字引
ソウジ	掃除
タテ	縦
ミナサン	皆さん
ギュウニュウ	牛乳
サライシュウ	再来週
コンバン	今晩
アルク	歩く
イヌ	犬
ヤサイ	野菜
ミミ	耳
ツトメル	勤める
タマゴ	卵
キッサテン	喫茶店
ナラベル	並べる
カカル	掛かる
カビン	花瓶
ハコ	箱
ダイジョウブ	大丈夫
アソコ	彼処
フロ	風呂
ハシ	箸
ゲンカン	玄関
キイロイ	黄色い
アツイ	暑い
ホンダナ	本棚
バン	晩
イモウト	妹
サトウ	砂糖
アネ	姉
カンジ	漢字
アタタカイ	暖かい
イス	椅子
クツ	靴
アサゴハン	朝御飯
ロウカ	廊下
カゼ	風邪
ハナ	鼻
オマワリサン	お巡りさん
ゴハン	ご飯
カワ	河
ツクエ	机
セマイ	狭い
キンヨウビ	金曜日
ゲツヨウビ	月曜日
スイヨウビ	水曜日
ドヨウビ	土曜日
ニチヨウビ	日曜日
モクヨウビ	木曜日
センタク	洗濯
ネコ	猫
コタエル	答える
シカシ	併し
ボウシ	帽子
オクサン	奥さん
タンジョウビ	誕生日
キップ	切符
サムイ	寒い
オバ	伯母
ワスレル	忘れる
フク	吹く
イクツ	幾つ
デキル	出来る
オテアライ	お手洗い
オニイサン	お兄さん
オジイサン	お祖父さん
オバアサン	お祖母さん
マタ	又
オオキナ	大きな
ナク	鳴く
オナカ	お腹
クモル	曇る
スズシイ	涼しい
オネエサン	お姉さん
サク	咲く
ミガク	磨く
ハク	履く
ダレカ	誰か
オカシ	お菓子
ハル	貼る
イツ	何時
ソレ	其れ
イクラ	幾ら
タバコ	煙草
クライ	暗い
コレ	此れ
タクサン	沢山
ドコ	何処
ソシテ	然して
ソレカラ	其れから
ヤル	遣る
ヌルイ	温い
イツモ	何時も
アナタ	貴方
ココ	此処
ソレデハ	其れでは
チョウド	丁度
ドウシテ	如何して
ウルサイ	煩い
オイシイ	美味しい
マズイ	不味い
マダ	未だ
コノ	此の
ツケル	点ける
ソウシテ	然うして
キレイ	綺麗
ショウユ	しょう油
ヨク	良く
ウタ	歌(う)
ハナ	話(す)
ワタ	渡(す)
ノボ	登(る)
ハイ	入(る)
ツク	作(る)
ハジ	始(まる)
チガ	違(う)
ツカ	使(う)
オシ	教(える)
カエ	返(す)
スワ	座(る)
ナラ	並(ぶ)
オボ	覚(える)
アラ	洗(う)
カエ	帰(る)
ワタ	渡(る)
ハシ	走(る)
ヤス	休(む)
タノ	頼(む)
アソ	遊(ぶ)
デカ	出掛(ける)
ナラ	習(う)
ツカ	疲(れる)
ハタラ	働(く)
コマ	困(る)
オヨ	泳(ぐ)
アル	歩(く)
ツト	勤(める)
ナラ	並(べる)
コタ	答(える)
ワス	忘(れる)
デキ	出来(る)
クモ	曇(る)
ミガ	磨(く)
