アカリ	明かり
アガル	上がる
ウタウ	歌う
ウケル	受ける
デル	出る
シュッコク	出国
ユキ	行き
イキ	行き
ダイブン	大分
ダイブ	大分
イカス	生かす
イキイキ	生き生き
レンチュウ	連中
キジ	生地
オオカタ	大方
ホウ	方
シホウ	四方
ホンバ	本場
ジョウズ	上手
ニュウシュ	入手
ガクリョク	学力
ミル	見る
ヨゲン	予言
ゲンニ	現に
シュツゲン	出現
ゴウリ	合理
リガク	理学
ゼンシャ	前者
ケンチ	見地
メシタ	目下
イジ	意地
タイキン	大金
ドウサ	動作
セイテキ	性的
デイリ	出入り
ヨウスルニ	要するに
トマル	止まる
テイレ	手入れ
テホン	手本
ホンジツ	本日
ネンジュウ	年中
サイキョウ	最強
ナガイ	長い
ニュウリョク	入力
ダイショウ	大小
ゴウセイ	合成
コウム	公務
モチヌシ	持ち主
キマル	決まる
ミエル	見える
トリキメ	取り決め
イジョウ	以上
イチニンマエ	一人前
ヘル	経る
トオル	通る
ツレル	連れる
ハズス	外す
オモイヤリ	思いやり
サイジョウ	最上
ホウゲン	方言
ハナシアウ	話し合う
トシウエ	年上
ウケトル	受け取る
クブン	区分
ダイタイ	大体
ヨウリョウ	要領
タダイ	多大
メアテ	目当て
コウシン	行進
サイ	歳
シュトシテ	主として
ジヌシ	地主
ゼンポウ	前方
ダイ	題
アラタメル	改める
ダイタスウ	大多数
サダメル	定める
ヒョウキ	表記
マワス	回す
ハヤイ	早い
ニンゲンセイ	人間性
ジハツテキ	自発的
ソウタイテキ	相対的
カナメ	要
シンマイ	新米
キョウコウ	強行
ムスビ	結び
チカラヅヨイ	力強い
キリョク	気力
ヒトデ	人出
ヒノデ	日の出
サイショウ	最小
トイアワセル	問い合わせる
コウチ	高地
ナナツ	七つ
オシエ	教え
ハツメイ	発明
フリツ	府立
カッキ	活気
コウゲン	高原
トシツキ	年月
ネンゲツ	年月
ムリヤリ	無理やり
トク	得
カイヤク	解約
コクメイ	国名
フコウヘイ	不公平
セイチョウ	生長
ツレ	連れ
ガイケン	外見
フシギ	不思議
イッコウニ	一向に
コウサイ	交際
シュッセ	出世
ウケトリ	受け取り
ジメン	地面
タブン	多分
ブンカテキ	文化的
ミアイ	見合い
アテ	当て
ハンドウ	反動
シンカ	進化
ジュウリョク	重力
ブンギョウ	分業
ジュウタイ	重体
ヘタ	下手
メイキ	明記
クカク	区画
サンセイケン	参政権
フホンイ	不本意
ヤスウリ	安売り
クル	来る
フサク	不作
モクテキチ	目的地
ニュウキン	入金
ココチ	心地
ヤシン	野心
シンジャ	信者
ゼンシュウ	全集
デアウ	出会う
メイブツ	名物
ナリタツ	成り立つ
ソトガワ	外側
ナリユキ	成り行き
ガッキ	学期
サイゴ	最期
ヒキワケ	引き分け
コウゲン	公言
ヒキダシ	引き出し
メイショ	名所
イッケン	一見
ゲンシ	原子
スイチュウ	水中
スイブン	水分
センケツ	先決
ウゴカス	動かす
ジョウキョウ	上京
シュッピン	出品
ヒトメ	人目
ジツメイ	実名
ダイメイ	題名
チメイ	地名
カワス	交わす
ガイジン	外人
オモイダス	思い出す
イイマワシ	言い回し
トッケン	特権
セソウ	世相
セイリ	生理
ナイメン	内面
ショウタイ	正体
ネンシ	年始
ミナオス	見直す
タモツ	保つ
クダサル	下さる
クダル	下る
トシシタ	年下
ハンメイ	判明
キニュウ	記入
カイメン	海面
コウカ	高価
リョウカイ	領海
フゴウリ	不合理
カクシン	確信
コウリ	小売
マエウリ	前売り
サドウ	作動
リセイ	理性
ケン	権
オワル	終わる
カイシン	会心
ケッシン	決心
シンジュウ	心中
シンチュウ	心中
ナイシン	内心
ブンリツ	分立
サク	策
シタク	支度
ツヨイ	強い
シイル	強いる
イチドウ	一同
ケンブツ	見物
サンブツ	産物
ショモツ	書物
イキモノ	生き物
モノゴト	物事
セイネン	成年
コウシ	公使
アラソウ	争う
ハシュツジョ	派出所
タイダン	対談
ウツ	撃つ
ムゴン	無言
ムスウ	無数
サイド	再度
シナモノ	品物
ヒトメ	一目
セイカイ	正解
ブンカイ	分解
ヒトマエ	人前
ニンマエ	人前
ウミダス	生み出す
セイネンガッピ	生年月日
ジョウリュウ	上流
シガイ	市外
マシ	増し
ムコウ	向こう
コクユウ	国有
ハッスル	発する
マギワ	間際
トクサン	特産
ミンワ	民話
カッテ	勝手
ニンジョウ	人情
ヘイメン	平面
メンボク	面目
メンモク	面目
タイチョウ	体長
コクゼイ	国税
ゼイカン	税関
ブンガクシャ	文学者
ケントウ	見当
シュツダイ	出題
リョウガワ	両側
テクビ	手首
カゾエル	数える
イマニ	今に
アトマワシ	後回し
ジサン	持参
フツウ	不通
ヒニチ	日日
ウリダス	売り出す
コウエイ	公営
クム	組む
ウンコウ	運行
ココノツ	九つ
シリアウ	知り合う
アンガイ	案外
ミヤゲ	土産
ドダイ	土台
ドウジョウ	道場
カジツ	果実
ガッカイ	学界
オイタチ	生い立ち
タツ	立つ
ケツゴウ	結合
カケツ	可決
ブンベツ	分別
フンベツ	分別
サクモツ	作物
ブッタイ	物体
オウタイ	応対
デンポウ	電報
ヒキアゲル	引き上げる
ヒキサゲル	引き下げる
サイゲツ	歳月
ミウチ	身内
キメル	決める
チョウショ	長所
ヨウショ	要所
ツグ	次ぐ
シダイ	次第
フカ	付加
スイヘイ	水平
フノウ	不能
キル	切る
セツジツ	切実
ムメイ	無名
ムヨウ	無用
ハンツキ	半月
サイカイ	再会
シャセツ	社説
ネンピョウ	年表
ソウロン	総論
ショクモツ	食物
マッサキ	真っ先
カリュウ	下流
オオドオリ	大通り
ヨキ	予期
ナガシ	流し
ミズマシ	水増し
ホセイ	補正
ウタガウ	疑う
タイカ	大家
ヨカン	予感
コウジツ	口実
ユウセイ	優勢
アヤマチ	過ち
イキスギ	行き過ぎ
イチブブン	一部分
チュウダン	中断
ヘン	変
ムダン	無断
ヨコク	予告
ナンラ	何ら
ナンジュウ	何十
ガンライ	元来
カクジ	各自
キンセイ	近世
クイチガイ	食い違い
ケシゴム	消しゴム
ショウカ	消化
リョウリツ	両立
サダマル	定まる
ホウキ	法規
デキアガリ	出来上がり
エイリ	営利
ジエイ	自営
セイタイ	生態
ロジ	路地
アキ	空き
ウンドウカイ	運動会
チセイ	知性
モチイル	用いる
ネンパイ	年配
キョウヨウ	強要
ムジョウケン	無条件
タイベツ	大別
クヤクショ	区役所
ジツブツ	実物
フヒツヨウ	不必要
カマウ	構う
カエル	代える
アケガタ	明け方
ヒキズル	引きずる
インヨウ	引用
コウテイ	公定
ワリアテ	割り当て
ナガモチ	長持ち
ホイクショ	保育所
ウケミ	受け身
ミノマワリ	身の回り
ヘンシン	変身
キマリ	決まり
ゲスイ	下水
ムカンケイ	無関係
ムカンシン	無関心
ハンニチ	半日
シタギ	下着
センチャク	先着
テイチャク	定着
ハッチャク	発着
ヒッチャク	必着
ノセル	乗せる
シュショク	主食
セイケイ	生計
シンカ	真価
セイシ	生死
クワワル	加わる
デンリュウ	電流
ナンカン	難関
ハズレル	外れる
タイカク	体格
フゴウカク	不合格
キョウユウ	共有
チョクセン	直線
ヒナタ	日向
テギワ	手際
ドウカン	同感
ハンカン	反感
ヒトクチ	一口
ビョウジョウ	病状
ヤサシイ	優しい
ハナス	話す
スクナイ	少ない
ショウショウ	少々
スクナカラズ	少なからず
ホウダイ	放題
ブンタイ	文体
ゾクシュツ	続出
ジョウヨウ	常用
ヘイジョウ	平常
ゲンシ	原始
ハジメル	始める
シハツ	始発
ハジメ	始め
ケイダイ	境内
サガル	下がる
サイケツ	裁決
ジョゲン	助言
フシゼン	不自然
アキチ	空き地
ドウセイ	同性
ダイゼンテイ	大前提
リョウクウ	領空
カギリ	限り
ジゲン	時限
コユビ	小指
テキチュウ	的中
シタシム	親しむ
ショシン	初心
ホンシン	本心
カガイシャ	加害者
スイガイ	水害
クバル	配る
キクバリ	気配り
ゾウゲン	増減
シリョク	視力
ムシ	無視
ショウダン	商談
チイサイ	小さい
ベツメイ	別名
ヤクバ	役場
テツダイ	手伝い
ソウオウ	相応
ホウジル	報じる
ヒキトル	引き取る
ソダチ	育ち
ツカイミチ	使い道
カキカタ	書き方
シュウラク	集落
ラクゴ	落語
カハンシン	下半身
コウツウヒ	交通費
ラク	楽
キラク	気楽
コノマシイ	好ましい
コウカン	好感
スイリョク	水力
ホンノウ	本能
オコス	起こす
キョウヨウ	共用
タイイン	退院
テイキ	提起
ムジツ	無実
ホッキニン	発起人
ユライ	由来
ミズギ	水着
キル	着る
コクソ	告訴
ジンメイ	人名
ナダカイ	名高い
ジキ	時機
カイテン	開店
センシ	戦死
エイブン	英文
クワエル	加える
チュウリュウ	中流
ナンカイ	難解
ナンテン	難点
ブナン	無難
ソウテイ	想定
ウシロムキ	後ろ向き
イエデ	家出
コウロン	口論
アカイ	赤い
デイリグチ	出入り口
トウジル	投じる
マイアサ	毎朝
リョウシュウショ	領収書
フヘン	不変
シイレ	仕入れ
シアゲ	仕上げ
ナニゴト	何事
ブンポウ	文法
ナンデ	何で
タイキ	待機
ススム	進む
シンニュウ	進入
タダシイ	正しい
アシクビ	足首
チョクツウ	直通
ワタス	渡す
イジュウ	移住
ケサ	今朝
ジツレイ	実例
コウサテン	交差点
タツ	建つ
ハル	張る
ハンエイ	反映
ムゲン	無限
ムキゲン	無期限
セイキュウ	性急
キュウキョク	究極
ツウコウドメ	通行止め
ジツザイ	実在
ソウシン	送信
ツイキュウ	追求
ハンゲン	半減
ビジン	美人
ビヨウ	美容
ショウニン	商人
フカ	不可
ヘンヨウ	変容
ギリ	義理
ジュウヤク	重役
ヒトリ	独り
イニン	委任
トモバタラキ	共働き
チケイ	地形
エンケイ	円形
フケイキ	不景気
シツボウ	失望
ジョウハンシン	上半身
ノゾム	望む
ユウボウ	有望
オチツキ	落ち着き
ガクヒ	学費
ノハラ	野原
タノシイ	楽しい
タノシム	楽しむ
チノウ	知能
オコル	起こる
オモイキリ	思い切り
カクシン	核心
ココロエ	心得
マンイチ	万一
バンノウ	万能
ラッカンテキ	楽観的
カンシュウ	観衆
ジョウシャ	乗車
ロンリテキ	論理的
シャコウ	社交
ショクヒ	食費
バイテン	売店
マッサイチュウ	真っ最中
カク	格
カクベツ	格別
フエル	増える
ホンセン	本線
ユウノウ	有能
ムカウ	向かう
カンジュセイ	感受性
ジハク	自白
フカメル	深める
ハツビョウ	発病
ビョウニン	病人
ヒクイ	低い
ホウチ	放置
タツ	断つ
ナンビャク	何百
ハンスル	反する
ブキミ	不気味
マチナカ	町中
オウ	負う
チュウ	注
ウツス	移す
コウバン	交番
ミトメ	認め
ジサ	時差
ハンレイ	判例
ヒザシ	日差し
ハイタツ	配達
ハッタツ	発達
ゼンゼン	全然
ベッコ	別個
オンキョウ	音響
セイカク	正確
フウン	不運
オヤユビ	親指
シンセツ	親切
フビ	不備
シタシミ	親しみ
チカドウ	地下道
ドウリ	道理
チカミチ	近道
ガイ	害
テハイ	手配
チュウコ	中古
ズノウ	頭脳
ゴク	極
サンスウ	算数
テンカ	天下
ワカレル	別れる
グンコクシュギ	軍国主義
ドクダン	独断
ミタス	満たす
ユウイギ	有意義
マンテン	満点
エンズル	演ずる
ヘンケイ	変形
テビキ	手引き
ネアガリ	値上がり
ヒキダス	引き出す
タリョウ	多量
ショウリョウ	少量
タイボウ	待望
ソウギ	争議
カンセツ	間接
タイガク	退学
ウツワ	器
ショッキ	食器
ガイカン	外観
ダイギシ	代議士
チャクシュ	着手
ウワギ	上着
ニッコウ	日光
ワショク	和食
イチダンラク	一段落
カイロ	回路
タイヒ	対比
ダンドリ	段取り
ノコル	残る
ムザン	無残
ヒトリ	一人
ノコラズ	残らず
カイソウ	回想
ナイカ	内科
デンセン	電線
ユウキブツ	有機物
ウタガワシイ	疑わしい
ノウリツ	能率
オウトウ	応答
モヨオシ	催し
ヨナカ	夜中
ヨアケ	夜明け
ジコウ	時効
ハナツ	放つ
ミハナス	見放す
チシツ	地質
ハカル	図る
ナンダカ	何だか
シュウカン	週間
オトコマエ	男前
マツ	待つ
タメス	試す
イチヨウ	一様
ロクガ	録画
シントウ	神道
テイサイ	体裁
センレイ	先例
デンタツ	伝達
コウゼン	公然
ヒツゼンテキ	必然的
リョウシン	良心
デンキュウ	電球
カイキ	回帰
ホドウ	歩道
ケツマツ	結末
ゲツマツ	月末
シマツ	始末
シュウテン	終点
キャッカン	客観
ドテ	土手
イソグ	急ぐ
カンゲキ	感激
キョクゲン	極限
ミキワメル	見極める
テンタイ	天体
ビジョ	美女
コウテイ	工程
アワセル	合わせる
デンゴン	伝言
オテツダイ	お手伝い
ケイシキテキ	形式的
ネビキ	値引き
キキトリ	聞き取り
ワカ	和歌
ラッカ	落下
オトス	落とす
ジッピ	実費
ヒコウ	非行
メンダン	面談
オウセツ	応接
コノム	好む
コウテン	好転
ホドコス	施す
チョクゲキ	直撃
カリョク	火力
ムロン	無論
バンニン	万人
バンジン	万人
バンザイ	万歳
ガクイ	学位
ショウヒン	賞品
セッキョウ	説教
ハヤサ	速さ
ブシ	武士
モノオキ	物置
ノリモノ	乗り物
ハナミ	花見
カイショク	会食
ウミベ	海辺
テイショク	定食
ニッショク	日食
ツウロ	通路
バイシュン	売春
トビダス	飛び出す
ナゴリ	名残
アッコウ	悪口
ワルクチ	悪口
ボウスイ	防水
ボウセン	防戦
シロイ	白い
マッシロ	真っ白
ネントウ	年頭
クチサキ	口先
フカマル	深まる
ゴウ	号
カイトウ	解答
サイク	細工
オサマル	収まる
オサメル	収める
コウリョク	効力
ダンジテ	断じて
ダンスイ	断水
ダンテイ	断定
アオゾラ	青空
ナンゼン	何千
マチウケル	待ち受ける
ホソク	補足
カトキ	過渡期
シッカク	失格
トウバン	当番
ムセキニン	無責任
サシヒキ	差し引き
ナラビ	並び
ナミ	並み
コウシュウ	公衆
タッスル	達する
ビョウシツ	病室
ダンゼン	断然
ヒツゼン	必然
カンモン	関門
ウツル	写る
ヒッパル	引っ張る
キドウタイ	機動隊
ムセイゲン	無制限
ソナワル	備わる
キャクシツ	客室
ワフウ	和風
フルイ	古い
カクチョウ	拡張
ハッソウ	発送
ヒケツ	否決
シュジュ	種々
イッシュウ	一周
シンドウ	振動
オモカゲ	面影
エンマン	円満
ヤクニタツ	役に立つ
オクガイ	屋外
カオク	家屋
トウキ	登記
ヨム	読む
ソダツ	育つ
シツリョウ	質量
ウタゴエ	歌声
ネマワシ	根回し
ミヂカ	身近
ハンシン	半身
カイテ	買い手
ニガイ	苦い
セツゾク	接続
ショウカ	消火
ジュワキ	受話器
カンネン	観念
シハン	市販
ノル	乗る
ゴゾンジ	ご存じ
デンエン	田園
キグ	器具
ヨウグ	用具
エイワ	英和
ヒコウジョウ	飛行場
イドウ	異動
トクイ	特異
ユウズウ	融通
ジタイ	辞退
シャドウ	車道
ニュウジョウケン	入場券
フカミ	深み
マッカ	真っ赤
キゴウ	記号
タンゴ	単語
タンコウボン	単行本
トウアン	答案
コンヤ	今夜
ホソイ	細い
ブンケン	文献
ヨゾラ	夜空
ゲンカク	厳格
フダン	不断
メイセイ	名声
アイズ	合図
トクシツ	特質
アイスル	愛する
ナニシロ	何しろ
ジッキョウ	実況
ヤブル	破る
ツム	積む
マチカマエル	待ち構える
ハツオン	発音
モウシアゲル	申し上げる
チョウミリョウ	調味料
トリケス	取り消す
イコウ	以降
カコウ	下降
ギフ	義父
シキベツ	識別
ムイシキ	無意識
イデン	遺伝
チョウカ	超過
ソソグ	注ぐ
ロウリョク	労力
ナミキ	並木
ジュウジ	従事
ハヤクチ	早口
ヒガエリ	日帰り
ヘイタイ	兵隊
ユウゲン	有限
ミマイ	見舞い
アヤウイ	危うい
アヤウク	危うく
サンリン	山林
リンギョウ	林業
サイテン	採点
スイリ	推理
アゲル	上げる
スイソ	水素
ホッキョク	北極
オイダス	追い出す
シュウキ	周期
コウミンカン	公民館
スイゾクカン	水族館
タイガ	大河
カワラ	河原
フリ	振り
ブリ	振り
ゲッキュウ	月給
コウロ	航路
ノボル	登る
トンヤ	問屋
トウヨウ	登用
ヒヤヤカ	冷ややか
ネサガリ	値下がり
モケイ	模型
ハツイク	発育
テキオウ	適応
ノゾマシイ	望ましい
オチバ	落ち葉
ケシキ	景色
シンユウ	親友
ヘイエキ	兵役
ムカエ	迎え
クミコム	組み込む
バンジ	万事
オチコム	落ち込む
カンショウ	観賞
スガオ	素顔
コウセン	光線
ノリキ	乗り気
ヨケイ	余計
ヒダリガワ	左側
クウソウ	空想
シャカイカガク	社会科学
コクハク	告白
オモシロイ	面白い
コウテイ	高低
モヨオス	催す
タンチョウ	単調
カンサン	換算
ツヤ	通夜
ヒキカエ	引き換え
ザダンカイ	座談会
ハッセイ	発声
イトシイ	愛しい
ダハ	打破
ヨウセキ	容積
ミツモリ	見積もり
タメシ	試し
ボウラク	暴落
ジョガイ	除外
シンプ	神父
セビロ	背広
モクロク	目録
キセイ	帰省
ナラビニ	並びに
ジムシツ	事務室
ミチ	未知
ミギガワ	右側
シュウギョウ	修業
サイゲン	際限
キマツ	期末
ジッシュウ	実習
シタシイ	親しい
シンニチ	親日
サイシュ	採取
タノミ	頼み
マナツ	真夏
フルホン	古本
ギンガ	銀河
コヅカイ	小遣い
ヒトカゲ	人影
ジキュウ	時給
ショニンキュウ	初任給
メイジル	命じる
メイチュウ	命中
オクナイ	屋内
チュウト	中途
ブンリョウ	分量
ベンロン	弁論
ギボ	義母
サンフジンカ	産婦人科
ネイロ	音色
クロイ	黒い
ボウカ	防火
ヒバナ	火花
ブンルイ	分類
アウ	会う
ムゾウサ	無造作
イセイ	異性
カンキン	監禁
シゼンカガク	自然科学
ルス	留守
アゲル	挙げる
テイケイ	定型
ケン	券
テイデン	停電
セキドウ	赤道
フリカエル	振り返る
ナイリク	内陸
マヨナカ	真夜中
サクヤ	昨夜
ユウベ	昨夜
チョウダイ	長大
デンゲン	電源
シオクリ	仕送り
アイチャク	愛着
アシオト	足音
ボウオン	防音
モウス	申す
マルイ	丸い
ユビワ	指輪
テッキン	鉄筋
センコク	宣告
ユイゴン	遺言
ショジョ	処女
ツキヒ	月日
マチナミ	町並み
アツイ	熱い
ミゼン	未然
ワシツ	和室
ミセイネン	未成年
シュクダイ	宿題
シュクメイ	宿命
ウツス	写す
キカ	帰化
ナガイキ	長生き
マウ	舞う
ランヨウ	乱用
ツラネル	連ねる
マツジツ	末日
ライキャク	来客
オリモノ	織物
カザムキ	風向き
ブンサン	分散
ショカ	初夏
ゴクラク	極楽
ソシツ	素質
アンピ	安否
コイ	故意
ウンガ	運河
フウセン	風船
ヨウガ	洋画
リョウジカン	領事館
ゼンイ	善意
マンメン	満面
ホンヤ	本屋
コンヤク	婚約
テイキアツ	低気圧
エンゲイ	園芸
キョヨウ	許容
コンジョウ	根性
マチノゾム	待ち望む
キンイロ	金色
コンジキ	金色
フロク	付録
セイテツ	製鉄
キンパク	緊迫
クルシイ	苦しい
クルシメル	苦しめる
フミキリ	踏切
ユウエキ	有益
ショウチ	承知
カオイロ	顔色
センニュウカン	先入観
ハヤイ	速い
ヒニヒニ	日に日に
ジュンバン	順番
ショウニカ	小児科
タヨリ	便り
ヒトダカリ	人だかり
アマル	余る
ホリュウ	保留
カキトメ	書留
テイキケン	定期券
オウサマ	王様
フカイ	深い
ジュヨ	授与
ヘンジョウ	返上
コウフク	幸福
ヒョウシキ	標識
コンダテ	献立
ネンチョウ	年長
ヤケイ	夜景
マナブ	学ぶ
キビシイ	厳しい
キキメ	効き目
キゲン	起源
ハキョク	破局
サイシ	妻子
ヘンニュウ	編入
ジメイ	自明
シュウリョウ	修了
ナカツギ	中継ぎ
トチョウ	都庁
アリサマ	有り様
ネラウ	狙う
イットウ	１等
ヨビダス	呼び出す
ヨビナ	呼び名
シュウネン	執念
カヤク	火薬
ハンガ	版画
ヤッキョク	薬局
ツクル	作る
ショホ	初歩
ソウシキ	葬式
ホウレイ	法令
ヒトドオリ	人通り
ソナエル	備える
フウリョク	風力
レイボウ	冷房
イイナリ	言いなり
ツノル	募る
オボエ	覚え
コウキョウキョク	交響曲
ミカク	味覚
ハゲシイ	激しい
ヒニン	否認
コウテイ	行程
セイシ	静止
バイゾウ	倍増
ザイモク	材木
セイミツ	精密
テイエン	庭園
ヒアタリ	日当たり
カケイ	家系
シンコン	新婚
トジョウ	途上
ミコン	未婚
ベンメイ	弁明
カアサン	母さん
シタミ	下見
サガリ	下がり
ジシュ	自首
ハクガイ	迫害
ブトウ	舞踏
デムカエ	出迎え
ゼイムショ	税務署
フイ	不意
デンチ	電池
ワガヤ	我が家
アクニン	悪人
シュッキン	出勤
テンキン	転勤
キンジル	禁じる
ルスバン	留守番
ジツヨウテキ	実用的
オオザッパ	大ざっぱ
オオマカ	大まか
ヨウジ	用事
シュウガクリョコウ	修学旅行
リョカクキ	旅客機
リョケン	旅券
リョヒ	旅費
ハイゼツ	廃絶
ヨクシ	抑止
ナオル	治る
テワケ	手分け
ヘンシン	返信
イマ	居間
ドウキョ	同居
リリク	離陸
カンキ	換気
キョウチョウ	強調
コウオン	高温
コンザツ	混雑
アットウ	圧倒
マルミ	丸み
アカリ	明り
シャリン	車輪
ウラナイ	占い
フカンゼン	不完全
フショウ	負傷
ロクオンテープ	録音テープ
エイキュウ	永久
スクイ	救い
キュウシキ	旧式
ショクブツエン	植物園
タウエ	田植え
ヘイコウ	並行
ナゴヤカ	和やか
ウエキ	植木
ワカル	分かる
チョウシュウ	徴収
イガイ	以外
ゲシュク	下宿
シャコ	車庫
ハン	版
マエモッテ	前もって
シュウシ	修士
ハンソク	反則
ホウソク	法則
オウダンホドウ	横断歩道
サンカク	三角
キシベ	岸辺
ムフウ	無風
ケッテン	欠点
ソクリョウ	測量
ゴクヒ	極秘
ホウサク	豊作
ゲンミツ	厳密
ミツド	密度
タテツヅケ	立て続け
コウキアツ	高気圧
ヨロコブ	喜ぶ
オオヨロコビ	大喜び
ベンカイ	弁解
ヨロコバス	喜ばす
コンキ	根気
ダイコン	大根
テキド	適度
カイチク	改築
アラタメテ	改めて
スバラシイ	素晴らしい
アッパク	圧迫
イシ	意志
クシン	苦心
アシブミ	足踏み
ヨウフク	洋服
エキイン	駅員
ハッカ	発火
シワス	師走
ヨビカケル	呼び掛ける
ハイフ	配布
チュウセイ	中性
ツトメ	勤め
タサツ	他殺
ヨウヤク	要約
インシ	印紙
ショウソク	消息
テイシャ	停車
ヨウコウ	要項
ヨクアツ	抑圧
サイワイ	幸い
ヒョウホン	標本
ベッキョ	別居
オンシツ	温室
ガイキ	外気
キショウ	気性
キタイ	気体
タイオン	体温
テイオン	低温
アイドク	愛読
アイヨウ	愛用
ドウ	同
ヨウテン	要点
アイソウ	愛想
アイソ	愛想
カンリョウ	完了
ムキュウ	無休
カキ	夏季
ガンボウ	願望
ハマベ	浜辺
コエル	越える
シメキル	締め切る
ヒッコシ	引っ越し
ハネ	羽根
コウトウガッコウ	高等学校
フツゴウ	不都合
フビョウドウ	不平等
スクウ	救う
チョウヘイ	徴兵
ウル	得る
カクトウ	格闘
ヨク	欲
ウリアゲ	売り上げ
クツウ	苦痛
ズツウ	頭痛
ヒッシュウ	必修
ロウカ	老化
カンショク	感触
ウマレツキ	生まれつき
ドウラン	動乱
ニッカン	日刊
ミダレル	乱れる
ランボウ	乱暴
フカヒ	不可避
サイシュウ	採集
ヨソオウ	装う
ソンエキ	損益
ソコナウ	損なう
サカサ	逆さ
タヨル	頼る
アッシュク	圧縮
タチバナシ	立ち話
ホケツ	補欠
モル	盛る
セイダイ	盛大
ゾクスル	属する
ウラギル	裏切る
カワギシ	河岸
サクジョ	削除
ドウカ	同化
キンイツ	均一
シンミツ	親密
ブンツウ	文通
ミツバイ	密売
ミアワセル	見合わせる
コウリョ	考慮
キザム	刻む
ユウソウ	郵送
オモイ	重い
ヨミカキ	読み書き
ニンソウ	人相
ラクサツ	落札
フム	踏む
フリエキ	不利益
ムカエル	迎える
トリコム	取り込む
ウチコム	打ち込む
ビョウシャ	描写
コワス	壊す
ギョウレツ	行列
ブンプ	分布
スズ	鈴
タンケン	探検
アンノジョウ	案の定
チョウカク	聴覚
ケンケツ	献血
アガル	挙がる
ヨウジン	用心
ギャクコウカ	逆効果
ハンギャク	反逆
シセツ	使節
セツヤク	節約
ソウシツ	喪失
コウウン	幸運
オトシダマ	お年玉
キュウヨウ	休養
ヨウシ	養子
ケイシ	軽視
オナジ	同じ
モクヨウ	木曜
ユダン	油断
マチカド	街角
カイドウ	街道
ジホウ	時報
ヒキツグ	引き継ぐ
スマス	済ます
シンド	震度
カセイ	火星
シュツガン	出願
ツキミ	月見
センダッテ	先だって
ドウトウ	同等
ヒガン	彼岸
ユウトウセイ	優等生
ケイジ	掲示
チュウワ	中和
ミワケ	見分け
コタイ	固体
オオアメ	大雨
ヒンメイ	品名
ヒゴロ	日ごろ
ヘイカイ	閉会
タタカウ	闘う
ヒビ	日々
ヒトツ	一つ
ショクヨク	食欲
ヨッキュウ	欲求
ヨクボウ	欲望
ロンジル	論じる
ツイセキ	追跡
フキソク	不規則
フヘイ	不平
クニ	国
クニグニ	国々
コッカイ	国会
ショウジル	生じる
ダイショウ	代償
ホウイ	包囲
ホウソウ	包装
チュウシャ	駐車
ヒトビト	人々
トシ	年
ネンネン	年々
シュウトク	習得
フヤス	増やす
オオイニ	大いに
タイカイ	大会
タイコク	大国
オトナ	大人
オオキイ	大きい
オオゲサ	大げさ
ジャクテン	弱点
コウスイ	香水
ジツワ	実話
フタツ	二つ
フタリ	二人
タイスル	対する
サイセンタン	最先端
カツ	勝つ
ホンゴク	本国
ホンニン	本人
ホンネン	本年
マッタン	末端
アラワレ	現れ
スイソク	推測
チュウネン	中年
ニッチュウ	日中
マイスウ	枚数
カイチョウ	会長
コッセツ	骨折
ナガサ	長さ
ナガネン	長年
ダス	出す
バケル	化ける
コトバヅカイ	言葉遣い
コウゴ	交互
ミッツ	三つ
ショケイ	処刑
サン	三
ドウイツ	同一
ミッシュウ	密集
コウテイ	校庭
トキ	時
ナカニワ	中庭
ドウジ	同時
ニチジ	日時
イチジ	一時
トキドキ	時々
ヒエル	冷える
ヒヤス	冷やす
ハナタバ	花束
コト	事
ジンジ	人事
ダイジ	大事
テツヤ	徹夜
ミズカラ	自ら
ジコク	自国
ナカヨク	仲良く
ユウダイ	雄大
エイコウ	栄光
キゾク	貴族
ギョウ	行
ギョウジ	行事
ギョウセイ	行政
テキセイ	適性
オコナウ	行う
カイシャ	会社
カイサツ	改札
シャカイ	社会
シャカイジン	社会人
シャチョウ	社長
チョッカン	直感
ホンシャ	本社
カイケン	会見
ミゴト	見事
ミダシ	見出し
ミホン	見本
ネンガッピ	年月日
タチヨル	立ち寄る
ルイジ	類似
ヨビカケ	呼びかけ
エキベン	駅弁
ジブン	自分
ジュウブン	十分
ワケル	分ける
ワカレル	分かれる
カイギ	会議
ギカイ	議会
ギチョウ	議長
クイコム	食い込む
ウシロ	後ろ
ウカベル	浮かべる
コワレル	壊れる
デマエ	出前
ゼンゴ	前後
ゼンネン	前年
ウリテ	売り手
オソラク	恐らく
ウツ	討つ
コクミン	国民
ジンミン	人民
クレル	暮れる
オソレル	恐れる
コウクウビン	航空便
ジンセイ	人生
イキル	生きる
セイゼン	生前
フベン	不便
イッショウ	一生
シュッショウ	出生
シュッセイ	出生
ウンドウジョウ	運動場
ウンドウバ	運動場
コクレン	国連
レンジツ	連日
ヒトリヒトリ	一人一人
キンモツ	禁物
イツツ	五つ
ゴブ	五分
キゴコロ	気心
カリル	借りる
シュッパツ	出発
ココロアタリ	心当たり
ツウヨウ	通用
ハツ	発
ハッケン	発見
ハッコウ	発行
ハッセイ	発生
アイダ	間
ジカン	時間
ニンゲン	人間
オソイ	遅い
チュウカン	中間
ネンカン	年間
ミンカン	民間
カンセツ	関節
タイニチ	対日
アガリ	上がり
ノボリ	上り
イチブ	一部
ダイブブン	大部分
ニクタイ	肉体
ブチョウ	部長
ブブン	部分
ホンブ	本部
ロコツ	露骨
ヒガシ	東
トウブ	東部
ノウニュウ	納入
ノリカエル	乗り換える
コウシャ	後者
キマグレ	気まぐれ
セイトウ	政党
タンキダイガク	短期大学
トウ	党
カイサンブツ	海産物
ケイソツ	軽率
ダイチ	大地
ツチ	地
チジョウ	地上
モチモノ	持ち物
カイゴウ	会合
マニアウ	間に合う
アウ	合う
アイマ	合間
ゴウドウ	合同
レンゴウ	連合
オウズル	応ずる
マニアワセル	間に合わせる
キリツ	規律
シチョウ	市長
シミン	市民
アバレル	暴れる
アクム	悪夢
ギョウシャ	業者
ジギョウ	事業
ミノル	実る
ヒキツギ	引き継ぎ
コクナイ	国内
シナイ	市内
ウチ	内
ナイブ	内部
エノグ	絵の具
ゲンジュウショ	現住所
ソウカン	相関
イッポウ	一方
ミカタ	見方
コウホウ	後方
ユクエ	行方
チホウ	地方
カタガタ	方々
ミセビラカス	見せびらかす
ミセル	見せる
ヨッツ	四つ
ヨン	四
イッテイ	一定
ミカヅキ	三日月
テイネン	定年
ドウジル	動じる
イマ	今
コンゲツ	今月
コンゴ	今後
ムチ	無知
ムホウ	無法
コンニチ	今日
コトシ	今年
イママデ	今まで
カイ	回
コンカイ	今回
サライネン	再来年
テジナ	手品
ゼンカイ	前回
アタラシイ	新しい
アラタ	新た
シンジン	新人
シンネン	新年
ホウイ	方位
メウエ	目上
カイジョウ	会場
アラワス	表す
イチバ	市場
シュツジョウ	出場
バアイ	場合
セイツウ	精通
ソウバ	相場
ロンズル	論ずる
ジョウチョ	情緒
ジョウショ	情緒
オカネ	お金
アクシュ	握手
イタイ	痛い
イチイン	一員
カイイン	会員
ギイン	議員
シャイン	社員
ナマヌルイ	生ぬるい
テイイン	定員
フレアイ	触れ合い
サンリュウ	三流
キュウ	九
ニホンシュ	日本酒
ニュウコク	入国
ニュウシャ	入社
ニュウジョウ	入場
ブツゾウ	仏像
センシュツ	選出
センテイ	選定
ニュウセン	入選
ユウスル	有する
エラブ	選ぶ
コクリツ	国立
シリツ	市立
タイリツ	対立
チュウリツ	中立
タチバ	立場
カンズル	感ずる
カイカイ	開会
カイハツ	開発
トクバイ	特売
ムクチ	無口
キョクセン	曲線
ミアゲル	見上げる
テマ	手間
テマエ	手前
センシュ	選手
アイテ	相手
オオテ	大手
トオリスギル	通り過ぎる
ドウドウ	堂々
ニチベイ	日米
グン	群
ムレ	群れ
シュツリョク	出力
バツグン	抜群
ヒョウリ	表裏
ウラガエシ	裏返し
コクリョク	国力
ガッカイ	学会
ガクシャ	学者
ガクセイ	学生
ガクチョウ	学長
ガクネン	学年
ガクブ	学部
ケンガク	見学
コドモ	子供
ダイガク	大学
チュウガク	中学
チュウガクセイ	中学生
ニュウガク	入学
ガクモン	学問
ウチアゲル	打ち上げる
トイ	問い
トウ	問う
タカイ	高い
タカサ	高さ
タカマル	高まる
タカメル	高める
ジダイ	時代
ダイキン	代金
ダイコウ	代行
ネンダイ	年代
カワリ	代わり
ソウゲン	草原
アキラカ	明らか
アカルイ	明るい
ミョウニチ	明日
アシタ	明日
アス	明日
オクユキ	奥行き
ジジツ	事実
ジツハ	実は
ジッコウ	実行
ジツリョク	実力
マコトニ	実に
ジツニ	実に
デンアツ	電圧
イチエン	一円
エン	円
エンダカ	円高
ハジマル	始まる
チュウサイ	仲裁
ヤク	約
カンレン	関連
カコイ	囲い
ギケツ	議決
ケッシテ	決して
ケツギ	決議
ケッテイ	決定
タイケツ	対決
ブンシ	分子
コウドウ	行動
ジドウ	自動
フンバル	踏ん張る
ウゴキ	動き
ドウイン	動員
ドウリョク	動力
ワフク	和服
カクスル	画する
シンニュウ	侵入
ゼンイン	全員
ゼンブ	全部
ゼンリョク	全力
ゼンコク	全国
ガイライゴ	外来語
モクゼン	目前
ダイヒョウ	代表
ハッピョウ	発表
イキキ	行き来
テガカリ	手掛かり
ツクリアゲル	作り上げる
センジョウ	戦場
センゼン	戦前
タイセン	大戦
タタカイ	戦い
センゴ	戦後
オキ	沖
フジュン	不順
ビンジョウ	便乗
カヨウ	通う
ドオリ	通り
ツウガク	通学
ツウコウ	通行
ミトオシ	見通し
ホカ	外
ハズレ	外れ
ガイコク	外国
ガイコクジン	外国人
ガイシュツ	外出
ガイショウ	外相
ガイブ	外部
コクガイ	国外
チョウコウ	聴講
ニゲル	逃げる
トウソウ	逃走
コンケツ	混血
モットモ	最も
サイゴ	最後
サイコウ	最高
サイダイ	最大
ネンショウ	燃焼
イイカタ	言い方
イワバ	言わば
ゲンドウ	言動
ハツゲン	発言
ヒトコト	一言
キュウヘン	急変
ダンゼツ	断絶
チョウセツ	調節
ゲンキン	現金
ゲンジツ	現実
ゲンバ	現場
ゲンダイ	現代
ゲンチ	現地
ジツゲン	実現
ヒョウゲン	表現
スイバク	水爆
ケイリ	経理
ゲンテン	減点
ダイリ	代理
チリ	地理
リジ	理事
オル	居る
シラベ	調べ
チョウシ	調子
チョウリ	調理
イッタイ	一体
ゴゲン	語源
ジンタイ	人体
ゼンタイ	全体
カラダ	体
タイチョウ	体調
タイリョク	体力
ホンタイ	本体
リッタイ	立体
カガク	化学
ゴウリカ	合理化
マックラ	真っ暗
ハチョウ	波長
メイアン	明暗
ナル	成る
ソウトウ	相当
タオス	倒す
アタリ	当たり
アタリマエ	当たり前
アテル	当てる
トウジシャ	当事者
トウジ	当時
トウニン	当人
トウセン	当選
トウジツ	当日
トウブン	当分
ホントウ	本当
ユウエンチ	遊園地
テアテ	手当
キゴ	季語
ムクイル	報いる
ハチ	八
ワル	割る
ツグ	継ぐ
コンワク	困惑
ロク	六
ウタ	歌
シヨウニン	使用人
セイガン	請願
キコエル	聞こえる
ジシュ	自主
オモニ	主に
シュタイ	主体
チュウショウ	中傷
ミンシュ	民主
アブラエ	油絵
シュジン	主人
ギダイ	議題
シュダイ	主題
モンダイ	問題
ヒッコス	引っ越す
サゲル	下げる
クダリ	下り
キドル	気取る
ハラッパ	原っぱ
ショクン	諸君
ジョウゲ	上下
ノリコエル	乗り越える
チカ	地下
シメル	締める
ブカ	部下
ミツケル	見つける
シュショウ	首相
モエル	燃える
ネンピ	燃費
クビ	首
イガイ	意外
イケン	意見
ケツイ	決意
ゴウイ	合意
ダイナシ	台無し
ドウイ	同意
シナギレ	品切れ
ホジュウ	補充
ムジ	無地
ヤワラグ	和らぐ
ヤワラゲル	和らげる
ケンジツ	堅実
コケイ	固形
ゴウホウ	合法
ホウホウ	方法
ホウガク	法学
ホウジン	法人
ミンポウ	民法
リッポウ	立法
シュウチャク	執着
フジュウブン	不十分
フトウ	不当
フホウ	不法
フメイ	不明
オクリモノ	贈り物
デキゴト	出来事
ホンライ	本来
ホシイ	欲しい
ライ	来
ライゲツ	来月
ライニチ	来日
ライネン	来年
オキモノ	置物
マジワル	交わる
ツナ	綱
サク	作
サギョウ	作業
サクシャ	作者
サクセン	作戦
タベル	食べる
ショクパン	食パン
ホッサ	発作
ヘイホウ	平方
シホンカ	資本家
カイリュウ	海流
ゴウリテキ	合理的
ジシュテキ	自主的
シンカン	新刊
ホウテキ	法的
モクテキ	目的
シュヨウ	主要
フセグ	防ぐ
ヨウスル	要する
フヨウ	不要
サヨウ	作用
ジツヨウ	実用
ダイヨウ	代用
ヨウイ	用意
セイサク	制作
セイテイ	制定
セイヤク	制約
タイセイ	体制
ハッシャ	発車
ブンボウグ	文房具
キキャク	棄却
ジチ	自治
セイジ	政治
クチカズ	口数
メイジ	明治
コウド	高度
コンド	今度
ノボル	上る
セイド	制度
タンテキ	端的
ネンド	年度
ハンパ	半端
ガイム	外務
ツトメル	務める
ジム	事務
ジムイン	事務員
ホウム	法務
メンスル	面する
ハカル	測る
ツヨサ	強さ
ツヨメル	強める
キョウカ	強化
キョウセイ	強制
キョウリョク	強力
グンシュウ	群衆
キブン	気分
ツヨキ	強気
ニンキ	人気
セツダン	切断
タイキ	大気
ハラウ	払う
ホンキ	本気
ヨウショク	洋食
ショウガクセイ	小学生
ドウセイ	動静
シチ	七
ジュウフク	重複
チョウフク	重複
ミツニュウコク	密入国
アワス	合わす
セイジン	成人
セイチョウ	成長
セイブン	成分
セイリツ	成立
アタル	当たる
キカン	期間
キジツ	期日
コウキ	後期
ジキ	時期
ゼンキ	前期
チョウキ	長期
テイキ	定期
ドウキ	同期
ヤツアタリ	八つ当たり
コウカイ	公開
コウヒョウ	公表
コウムイン	公務員
コウメイ	公明
コウヤク	公約
コウリツ	公立
タバ	束
タル	足る
テッスル	徹する
カネモチ	金持ち
ミチガエル	見違える
モツ	持つ
シンサツ	診察
オオサワギ	大騒ぎ
キモチ	気持ち
モチ	持ち
ブンヤ	分野
ヤガイ	野外
ヤトウ	野党
キョウギ	協議
キョウリョク	協力
ザイバツ	財閥
トル	取る
トッテ	取っ手
トリシラベ	取り調べ
ミドコロ	見どころ
シュト	首都
ミヤコ	都
トカイ	都会
ツゴウ	都合
トシ	都市
トナイ	都内
トリツ	都立
セイタン	生誕
チョウワ	調和
トウイツ	統一
トウゴウ	統合
トウチ	統治
トウセイ	統制
イカ	以下
イゴ	以後
イゼン	以前
イナイ	以内
イライ	以来
コウゴ	口語
ハヘン	破片
ウワキ	浮気
カタテ	片手
キカイ	機会
キカン	機関
キタイ	機体
キチョウ	機長
ドウキ	動機
マドワス	惑わす
ケイイ	敬意
コウヘイ	公平
ヘイジツ	平日
ヘイネン	平年
ヘイヤ	平野
ヘイワ	平和
ワヘイ	和平
ヘイセイ	平成
カラッポ	空っぽ
フタゴ	双子
ソウカイ	総会
ソウリ	総理
ドウヨウ	動揺
ソウゴウ	総合
カニュウ	加入
ツトメサキ	勤め先
コウコウ	孝行
ナカユビ	中指
ヤマ	山
オモワズ	思わず
カリ	借り
ダッスイ	脱水
ダツラク	脱落
トウタツ	到達
オモイ	思い
オモイデ	思い出
オモウ	思う
ダッソウ	脱走
カジ	家事
ヤヌシ	家主
カナイ	家内
ハタス	果たす
コッカ	国家
サッカ	作家
ジッカ	実家
セイジカ	政治家
アタエル	与える
タビダツ	旅立つ
イッカ	一家
カイワ	会話
シンシツ	寝室
タイワ	対話
ツウワ	通話
ワダイ	話題
ハナシ	話
ハナシアイ	話し合い
ショキュウ	初級
ヨノナカ	世の中
セケン	世間
セダイ	世代
セワ	世話
チュウセイ	中世
ドアイ	度合
ウケイレル	受け入れる
ソウベツ	送別
クカン	区間
ハンシャ	反射
ヨウケン	用件
キマエ	気前
ダイトウリョウ	大統領
ミレン	未練
アタタカイ	温かい
カクス	隠す
カヨウ	火曜
カヨウビ	火曜日
ケンリツ	県立
ドクガク	独学
ジゾク	持続
ソウゾク	相続
ナイゾウ	内臓
レンゾク	連続
ゾクゾク	続々
テツヅキ	手続き
ツヅキ	続き
エンジル	演じる
シンガク	進学
シンコウ	進行
シンシュツ	進出
ゼンシン	前進
コウセイ	公正
シュウデン	終電
セイ	正
ショウガツ	正月
セイトウ	正当
タイショウ	大正
フセイ	不正
ナガビク	長引く
アンゼン	安全
アンテイ	安定
エンヤス	円安
ガンショ	願書
ケンブン	見聞
チアン	治安
フアン	不安
フアンテイ	不安定
メヤス	目安
カイセツ	開設
カンスル	関する
コウバイ	購買
スギ	杉
セッテイ	設定
セツリツ	設立
シヒ	私費
ハッキ	発揮
ホアン	保安
トコロドコロ	所々
カイセイ	改正
ゲンショ	原書
トリダス	取り出す
ナヅケル	名付ける
トリキメ	取決め
カイスウ	回数
スウガク	数学
ソウスウ	総数
タスウ	多数
ニンズウ	人数
カズ	数
ニッスウ	日数
ヒキオコス	引き起こす
シルス	記す
キジ	記事
キシャ	記者
ニッキ	日記
ダイガクイン	大学院
ニュウイン	入院
ウキ	雨期
オンナ	女
オンナノコ	女の子
ジョシ	女子
ジョセイ	女性
チョウジョ	長女
トウナン	盗難
ニッシ	日誌
メダツ	目立つ
サイショ	最初
シバフ	芝生
ハツ	初
ショキ	初期
ショニチ	初日
ダケツ	妥結
コロガス	転がす
コロガル	転がる
トウショ	当初
キタ	北
ホクブ	北部
ホクトウ	北東
クイサガル	食い下がる
ゴゴ	午後
ゴゼン	午前
ショウゴ	正午
タイショウ	対照
ユビ	指
シテイ	指定
テンケイテキ	典型的
オモテドオリ	表通り
イザカヤ	居酒屋
ケンリョク	権力
シカ	歯科
シュケン	主権
ジンケン	人権
セイケン	政権
ネンガジョウ	年賀状
アツカウ	扱う
アンシン	安心
カンシン	関心
シンリ	心理
チヘイセン	地平線
チュウシン	中心
トシン	都心
ナイコウ	内向
ギョウカイ	業界
ヨワキ	弱気
セカイ	世界
セイカイ	政界
キュウビョウ	急病
シジ	支持
シシャ	支社
シシュツ	支出
ヤム	病む
ナサケ	情け
ドアイ	度合い
ツトメ	務め
コクサン	国産
サンギョウ	産業
サンチ	産地
シュッサン	出産
セイサン	生産
フドウサン	不動産
ムスブ	結ぶ
ケッセイ	結成
ウラグチ	裏口
チュウジツ	忠実
マメ	忠実
ヒャク	百
マエバライ	前払い
ハデ	派手
リッパ	立派
チテン	地点
テン	点
テンスウ	点数
エンリョ	遠慮
キョウイン	教員
キョウカイ	教会
デアウ	出合う
ザッソウ	雑草
ココロミル	試みる
モトモト	元々
ケイザイ	経済
モノタリナイ	物足りない
ケイザイテキ	経済的
チガウ	違う
ショキ	書記
サワグ	騒ぐ
ダイブツ	大仏
ケス	消す
セイフ	政府
チメイテキ	致命的
ヨクチョウ	翌朝
ヨクアサ	翌朝
カツドウ	活動
カッパツ	活発
カツヨウ	活用
カツリョク	活力
セイカツ	生活
ゲンサク	原作
ゲンシリョク	原子力
ゲンテン	原点
ゲンリ	原理
ハレ	晴れ
サキニ	先に
センゲツ	先月
センシンコク	先進国
センセイ	先生
センジツ	先日
フクヨウ	服用
キョウツウ	共通
コウキョウ	公共
ジュウコウギョウ	重工業
キョウドウ	共同
シュトク	取得
ココロエル	心得る
トクイ	得意
カイケツ	解決
カイタイ	解体
ケンカイ	見解
リカイ	理解
ワカイ	和解
オマエ	お前
シメイ	氏名
ハイレツ	配列
ホンミョウ	本名
メイサク	名作
メイジン	名人
ナマエ	名前
メイモク	名目
ヨリカカル	寄り掛かる
ガイコウ	外交
コウツウ	交通
コッコウ	国交
セイボ	歳暮
コウタイ	交代
シキン	資金
シサン	資産
シホン	資本
ジガ	自我
ヨセン	予選
ヨテイ	予定
ヨホウ	予報
ヨヤク	予約
エンバン	円盤
オガワ	小川
カワ	川
フウシ	風刺
ムキ	向き
コウジョウ	向上
マエムキ	前向き
ドウコウ	動向
ヒッシャ	筆者
ホウコウ	方向
イコウ	意向
コクサイ	国際
コクサイカ	国際化
コクサイテキ	国際的
サイ	際
キワダツ	際立つ
ジッサイ	実際
ネル	寝る
チョウサ	調査
ケッショウ	決勝
アラワス	現す
マサル	勝る
カチ	勝ち
イチメン	一面
ウケトリ	受取り
ウケトリ	受取
ウケトリ	受け取
バメン	場面
ゼンメンテキ	全面的
テンキョ	転居
ニュウヨク	入浴
ヒョウメン	表面
ホウメン	方面
メンカイ	面会
ツラ	面
オモテ	面
メン	面
イイン	委員
イインカイ	委員会
ゲンコク	原告
ヒロメル	広める
ツゲル	告げる
フジョウリ	不条理
ホオン	保温
ホウコク	報告
アタタマル	温まる
キハン	規範
カメン	仮面
グン	軍
グンジ	軍事
グンジン	軍人
タカラクジ	宝くじ
ホウセキ	宝石
サクブン	作文
ブンカ	文化
ブンガク	文学
ブンメイ	文明
ブンショ	文書
ホンブン	本文
ホンモン	本文
ドウトク	道徳
ハンセン	反戦
ハンタイ	反対
ハンパツ	反発
ナリユキ	成行き
モト	元
ゲンキ	元気
ゲンシュ	元首
ガンジツ	元日
テモト	手元
ジモト	地元
ヒニク	皮肉
オモサ	重さ
カサネル	重ねる
ジュウシン	重心
ジュウダイ	重大
ジュウテン	重点
ジュウヨウ	重要
タイジュウ	体重
チョウホウケイ	長方形
ニジュウ	二重
フタエ	二重
ハクチョウ	白鳥
オモミ	重み
ワレメ	割れ目
マヂカ	間近
リョウシ	漁師
チカイ	近い
キンダイ	近代
サイキン	最近
セイザ	星座
マルイ	円い
セン	千
キョウリ	郷里
カンガエ	考え
カンガエル	考える
シコウ	思考
ハンケツ	判決
ハンジ	判事
ハンテイ	判定
コウニン	公認
カク	画
ガカ	画家
ガメン	画面
キリツ	起立
ムジョウ	無情
カッキテキ	画期的
ゲヒン	下品
ウミ	海
カイガイ	海外
カイグン	海軍
カイジョウ	海上
コサメ	小雨
フトクイ	不得意
イイワケ	言い訳
サンカ	参加
サンギイン	参議院
サンコウ	参考
ハキ	破棄
ウル	売る
ハツバイ	発売
ウリバ	売り場
キンリ	金利
ケンリ	権利
ショウリ	勝利
フリ	不利
リシ	利子
リヨウ	利用
タタカウ	戦う
マゴコロ	真心
クミアイ	組合
ヒトトオリ	一通り
クマ	熊
シル	知る
チジ	知事
チジン	知人
チテキ	知的
ツウチ	通知
ヨチ	予知
シリアイ	知り合い
アンナイ	案内
レンソウ	連想
カワラ	川原
コクドウ	国道
ショドウ	書道
ジンドウテキ	人道的
チュウドウ	中道
ミチ	道
ホウドウ	報道
ジシン	自信
ジュシン	受信
シンヨウ	信用
ツウシン	通信
ハッシン	発信
フシン	不信
シン	信
セイサク	政策
タイサク	対策
トクギ	特技
スゴス	過ごす
アツマル	集まる
アツメル	集める
シュウカイ	集会
シュウゴウ	集合
シュウチュウ	集中
テノヒラ	手のひら
アツマリ	集まり
ゲンザイ	現在
ザイガク	在学
ザイニチ	在日
ジュウショウ	重症
フザイ	不在
ジケン	事件
コウダン	公団
シュウダン	集団
ワラウ	笑う
ダンケツ	団結
ダンタイ	団体
ダンチ	団地
キシツ	気質
カタギ	気質
クベツ	区別
セイベツ	性別
ベツニ	別に
ワカレ	別れ
ベツモンダイ	別問題
ベツベツ	別々
グン	郡
ジナン	次男
ジンブツ	人物
ドウブツ	動物
ネンイリ	念入り
ウリモノ	売り物
ブッシ	物資
ブツリ	物理
ホンモノ	本物
ソクメン	側面
ウチガワ	内側
モトヅク	基づく
シュニン	主任
ニンイ	任意
ニンキ	任期
ニンム	任務
ゴウイン	強引
センザイ	洗剤
トリヒキ	取引
ヒキガネ	引き金
ヒキツヅキ	引き続き
コウシ	行使
ツカイ	使い
ツカウ	使う
シヨウ	使用
タイシ	大使
ナコウド	仲人
ツマル	詰まる
キュウジン	求人
イタス	致す
ヨウキュウ	要求
ウチケス	打ち消す
ニセ	偽
キンジョ	近所
ジムショ	事務所
モチナオス	持ち直す
ショトク	所得
バショ	場所
クダス	下す
ジカイ	次回
ジゲン	次元
シダイニ	次第に
カイスイ	海水
ミズ	水
スイデン	水田
スイドウ	水道
スイメン	水面
ミトメル	認める
スイサン	水産
コウハン	後半
タイハン	大半
ハン	半
ナカバ	半ば
ハンスウ	半数
ハンブン	半分
ハンメン	半面
タナバタ	七夕
ゼンハン	前半
ハントシ	半年
ハンネン	半年
タトエ	例え
タトエル	例える
サクヒン	作品
オカス	侵す
ニチヨウヒン	日用品
ブヒン	部品
オマイリ	お参り
サクネン	昨年
マイル	参る
カタホウ	片方
ギロン	議論
ケツロン	結論
ゲンロン	言論
コウフ	公布
ハンロン	反論
フタシカ	不確か
リロン	理論
ロンブン	論文
ロンリ	論理
セロン	世論
ヨロン	世論
カケイ	家計
カイケイ	会計
ケイ	計
ケイカク	計画
ゴウケイ	合計
トケイ	時計
シャセイ	写生
セッケイ	設計
トウケイ	統計
バクロ	暴露
ウツル	映る
シシャ	死者
シタイ	死体
リョウガエ	両替
ナイショク	内職
メンゼイ	免税
ミズシラズ	見ず知らず
サイマツ	歳末
ゾウカ	増加
ゾウダイ	増大
ノガレル	逃れる
メイアン	名案
スエッコ	末っ子
ヒマシニ	日増しに
オマモリ	お守り
マワリミチ	回り道
カンケイ	関係
キュウソク	休息
ドマ	土間
カカリ	係
ハテシナイ	果てしない
カンジ	感じ
カンジル	感じる
カンシン	感心
カンドウ	感動
キョウカン	共感
ジッカン	実感
タチアガル	立ち上がる
リンジン	隣人
ガイスル	害する
トクニ	特に
トクシュウ	特集
トクテイ	特定
トクベツ	特別
カンジョウ	感情
ジジョウ	事情
ジョウ	情
ジョウホウ	情報
ドウジョウ	同情
ヒョウジョウ	表情
ジツジョウ	実情
トウシ	投資
トウショ	投書
ドウハン	同伴
シジ	指示
シメス	示す
ビヨウイン	美容院
リキム	力む
アイカワラズ	相変わらず
タイヘン	大変
カワル	変わる
ヘンカ	変化
ヘンドウ	変動
ヒロガル	広がる
オトコ	男
オトコノコ	男の子
ダンシ	男子
ダンジョ	男女
ダンセイ	男性
チョウナン	長男
モドス	戻す
キチ	基地
キホン	基本
オシエル	教える
ハレツ	破裂
シリツ	私立
ヒキワケ	引分け
スム	済む
コトリ	小鳥
カザリ	飾り
カザル	飾る
ソウショク	装飾
ムケイ	無形
ヒキダシ	引出し
シタガキ	下書き
カイシ	開始
マルミ	円み
ハジマリ	始まり
ミノウエ	身の上
カシ	貸し
シマ	島
ハントウ	半島
ショウジキ	正直
タダチニ	直ちに
チョクゴ	直後
チョクゼン	直前
ツイヤス	費やす
トリハズス	取り外す
リョウシャ	両者
リョウテ	両手
リョウホウ	両方
リョウメン	両面
キヅク	気付く
コウツゴウ	好都合
アサ	朝
アサヒ	朝日
カイカク	改革
カクシン	革新
カワ	革
ムシン	無心
ウテン	雨天
チカ	地価
テイカ	定価
ノウコウ	濃厚
ノウシュク	濃縮
ブッカ	物価
ベイカ	米価
マンビキ	万引き
カクイ	各位
コウシキ	公式
セイシキ	正式
ゾウヨ	贈与
タシカメル	確かめる
カクジツ	確実
カクテイ	確定
カクニン	確認
カクホ	確保
カクリツ	確立
ハジメ	初め
メイカク	明確
コウリ	小売り
タシカ	確か
クイトメル	食い止める
ムラ	村
タツ	経つ
ショウカイ	照会
ゼンテイ	前提
テイアン	提案
テイシュツ	提出
コヅツミ	小包
ウン	運
ハコブ	運ぶ
ウンドウ	運動
ウンヨウ	運用
テイタク	邸宅
ニリュウ	二流
サイシュウ	最終
オエル	終える
シュウシ	終始
シュウセン	終戦
オワリ	終わり
センキョ	選挙
サイチュウ	最中
クダモノ	果物
カイコ	回顧
ケッカ	結果
セイカ	成果
ハタシテ	果たして
ケンメイ	賢明
ニシ	西
セイブ	西部
トウザイ	東西
ホクセイ	北西
イタン	異端
エキタイ	液体
スギル	過ぎる
アラワレル	現れる
アラワレル	現われる
ジョウセイ	情勢
イキオイ	勢い
セイリョク	勢力
ドウジョウ	同上
ミョウジ	名字
カゲン	加減
ガイメン	外面
ヘラス	減らす
ヘル	減る
ウケモチ	受け持ち
ダイ	台
ダイドコロ	台所
シラベル	調べる
リョウシュウ	領収
ヒロイ	広い
ヒロサ	広さ
ヒロマル	広まる
コウコク	広告
ヒロバ	広場
コウダイ	広大
ワライゴエ	笑い声
ウデドケイ	腕時計
ヒロゲル	広げる
シイレル	仕入れる
ナイヨウ	内容
イルイ	衣類
セイショ	聖書
カナラズ	必ず
カナラズシモ	必ずしも
ヒツヨウ	必要
ヒッシ	必死
イチオウ	一応
オウジル	応じる
オウヨウ	応用
ゴジュウオン	五十音
タイオウ	対応
チャイロ	茶色
ハンノウ	反応
テイオン	低音
エンシュツ	演出
コウエン	公演
シュエン	主演
シュツエン	出演
ジョウエン	上演
クサバナ	草花
ソクザ	即座
アジワウ	味わう
サン	酸
オモンジル	重んじる
デンキ	電気
デンシ	電子
デンリョク	電力
デンワ	電話
ハツデン	発電
ハツデンショ	発電所
マチガエル	間違える
ナカヨシ	仲良し
イキチガイ	行き違い
マチガウ	間違う
ジュウショ	住所
ジュウミン	住民
バチ	罰
イッコウ	一行
イチギョウ	一行
エンセン	沿線
ミワタス	見渡す
センソウ	戦争
アラソイ	争い
タチナオル	立ち直る
ロンソウ	論争
ミドコロ	見所
カイダン	会談
ミオロス	見下ろす
ショウドウ	衝動
ソウダン	相談
ダンワ	談話
ナカツギ	中次ぎ
ムシンケイ	無神経
キノウ	機能
ニカヨウ	似通う
セイノウ	性能
ノウ	能
ノウリョク	能力
ケイカイ	軽快
フカイ	不快
ブジ	無事
ムジン	無人
ムリ	無理
ムリョク	無力
ユウヒ	夕日
フタタビ	再び
サイカイ	再開
サイサン	再三
サイセイ	再生
ナワバリ	縄張り
オンナラシイ	女らしい
センゾ	先祖
チイ	地位
ブンゴ	文語
デキアガル	出来上がる
セッチ	設置
イチ	位置
キカク	企画
キギョウ	企業
ヘイコウ	平行
ユウグレ	夕暮れ
キキョウ	帰京
トリクム	取り組む
シンイ	真意
シンジツ	真実
シンソウ	真相
シンリ	真理
ケガワ	毛皮
モウフ	毛布
マンナカ	真ん中
ユルガス	揺るがす
イチリュウ	一流
コウリュウ	交流
テサグリ	手探り
ハリガネ	針金
シリアウ	知合う
ナガス	流す
ナガレ	流れ
リュウツウ	流通
ミドリイロ	緑色
カカク	価格
コウシ	格子
ゴウカク	合格
シカク	資格
ジンカク	人格
セイカク	性格
ホンカクテキ	本格的
アズケル	預ける
ショユウ	所有
ココロヅヨイ	心強い
トクユウ	特有
ユウケンシャ	有権者
ウム	有無
ユウメイ	有名
ユウリョク	有力
ヒヤケ	日焼け
ユウリ	有利
ウタガイ	疑い
ギモン	疑問
シンジル	信じる
ヨウギシャ	容疑者
クチ	口
デグチ	出口
ジンコウ	人口
ナヤム	悩む
イリグチ	入り口
スギ	過ぎ
カハンスウ	過半数
ケイカ	経過
ショウスル	称する
セイシ	制止
ツウカ	通過
カエス	返す
キョク	局
ケッキョク	結局
シキョク	支局
セイキョク	政局
トウキョク	当局
セボネ	背骨
ヨクシツ	浴室
ヤキニク	焼き肉
ゲンショウ	減少
スコシ	少し
ショウスウ	少数
ショウネン	少年
タショウ	多少
ショウジョ	少女
スクナクトモ	少なくとも
イクジ	意気地
カイホウ	解放
カイホウ	開放
キニイル	気に入る
ホウル	放る
モハン	模範
カンゼイ	関税
コクホウ	国宝
ゼイキン	税金
ゾウゼイ	増税
ホウテイシキ	方程式
ケンサ	検査
ケンジ	検事
ケンテイ	検定
コトガラ	事柄
ショウスウテン	小数点
テンケン	点検
ヒトリゴト	独り言
マンゲツ	満月
キイロ	黄色
ミチル	満ちる
フクム	含む
オドロカス	驚かす
ホノオ	炎
シタマチ	下町
アカス	明かす
メイロ	迷路
マチ	町
インリョク	引力
ツネニ	常に
セイジョウ	正常
ネウチ	値打ち
ツウジョウ	通常
ニチジョウ	日常
フウ	封
ヒキアゲル	引上げる
ヒキウケル	引き受ける
ヒキサゲル	引下げる
ガッコウ	学校
コウチョウ	校長
コウコウ	高校
コウコウセイ	高校生
ショウガッコウ	小学校
チュウガッコウ	中学校
ゲンリョウ	原料
シリョウ	資料
ムリョウ	無料
ユウリョウ	有料
リョウキン	料金
リョウリ	料理
スナハマ	砂浜
サイバン	裁判
サイバンショ	裁判所
トリアゲル	取り上げる
セイサイ	制裁
ソウサイ	総裁
エンブン	塩分
ゲンジョウ	現状
オオミズ	大水
ミズイラズ	水入らず
カコウ	加工
オキル	起きる
コウガク	工学
コウギョウ	工業
コウサク	工作
コウジ	工事
ジンコウ	人工
ダイク	大工
ナゴム	和む
ケンセツ	建設
タテモノ	建物
サイケン	再建
ブキヨウ	不器用
フウサ	封鎖
タテマエ	建前
ガイコクゴ	外国語
ゲンゴ	言語
カタル	語る
ゴガク	語学
コウカ	硬貨
コクゴ	国語
シュカン	主観
フチャク	付着
モノガタリ	物語
モノガタル	物語る
トジル	閉じる
ヨウゴ	用語
キゾウ	寄贈
キュウ	球
ゲッコウ	月光
チキュウ	地球
ヤキュウ	野球
ユイショ	由緒
メイゲツ	名月
ウンエイ	運営
イトナム	営む
エイギョウ	営業
カンショク	間食
ケイエイ	経営
コクエイ	国営
ヒラタイ	平たい
クウ	食う
トトノウ	整う
クウカン	空間
クウキ	空気
クウグン	空軍
カラテ	空手
クウチュウ	空中
ゲキレイ	激励
ジョウクウ	上空
マジメ	真面目
ワルモノ	悪者
ショクイン	職員
ショクギョウ	職業
ショクバ	職場
ショクニン	職人
ショクム	職務
テキタイ	敵対
ムショク	無職
ケンショウ	検証
ハグルマ	歯車
サカヤ	酒屋
ショウショ	証書
ショウメイ	証明
ホショウニン	保証人
ヨウシュ	洋酒
ホショウ	保証
コクド	国土
オモイアガル	思い上がる
スイヘイセン	水平線
タイノウ	滞納
ツチ	土
トチ	土地
リョウド	領土
ヨワイ	弱い
ビョウジャク	病弱
ヨトウ	与党
ヒキイル	率いる
キュウ	急
キュウコウ	急行
キュウセイ	急性
キュウゾウ	急増
トッキュウ	特急
ウケトメル	受け止める
チクセキ	蓄積
チュウシ	中止
リョウハシ	両端
ウメタテ	埋め立て
ミオクリ	見送り
ミオクル	見送る
オクル	送る
ソウキン	送金
ヒンプ	貧富
ホウソウ	放送
ウンソウ	運送
オウエン	応援
コウエン	後援
シエン	支援
トモ	供
サクセイ	作製
テイキョウ	提供
イフク	衣服
カノウ	可能
サシズ	指図
ショウニン	小人
コビト	小人
ズヒョウ	図表
ニンカ	認可
フカノウ	不可能
ナンテ	何て
サル	去る
ゲンエキ	現役
シヤクショ	市役所
シュヤク	主役
オトコラシイ	男らしい
ヒルスギ	昼過ぎ
ヒルヤスミ	昼休み
チュウヤ	昼夜
ビョウヨミ	秒読み
ヤク	役
ヤクシャ	役者
ヤクショ	役所
ヤクニン	役人
ヤクメ	役目
キコウ	機構
ケッコウ	結構
コウセイ	構成
コウオン	高音
チャノマ	茶の間
ナガツヅキ	長続き
サンセキ	山積
ミナサマ	皆様
シヨウ	私用
ソウモク	草木
クサキ	草木
ワリダス	割り出す
マケル	負ける
ブンカツ	分割
ヤクワリ	役割
ワリ	割り
ワリアイ	割合
ワリビキ	割引
シンブン	新聞
シンブンシャ	新聞社
キカス	聞かす
キキテ	聞き手
ノミミズ	飲み水
ジシン	自身
シュッシン	出身
ショバツ	処罰
シンシン	心身
ミモト	身元
シンチョウ	身長
ミブン	身分
モウケル	設ける
ゼンシン	全身
ナカミ	中身
カイヒ	会費
ケイヒ	経費
コクヒ	国費
ヒヨウ	費用
ナオス	直す
タクス	託す
コウフ	交付
セイテン	晴天
ソウフ	送付
ヒヅケ	日付
フチュウイ	不注意
ツキアイ	付き合い
フキン	付近
トル	撮る
シセツ	施設
ジッシ	実施
シコウ	施行
イッサイ	一切
カイソク	快速
コギッテ	小切手
キリ	切り
キッテ	切手
タイセツ	大切
オモイキッテ	思い切って
ケイユ	経由
ジユウ	自由
テブクロ	手袋
フジユウ	不自由
ヨシ	由
リユウ	理由
ヤトウ	雇う
エンゼツ	演説
カイセツ	解説
ガクセツ	学説
ショウセツ	小説
セットク	説得
セツメイ	説明
テンサイ	天災
タハタ	田畑
カタミチ	片道
ジョセイテキ	女性的
ウンテン	運転
ウンテンシュ	運転手
カイテン	回転
カケ	掛け
カンシュウ	慣習
ハヤオキ	早起き
ガイショク	外食
ケイエン	敬遠
タベモノ	食べ物
ショクジ	食事
ショクヒン	食品
ショクリョウ	食料
チョウショク	朝食
ヒメイ	悲鳴
クラベル	比べる
ユル	揺る
ムズカシイ	難しい
ナンミン	難民
ナンモン	難問
コクボウ	国防
セキセツ	積雪
モッパラ	専ら
オオユキ	大雪
ボウシ	防止
ヨボウ	予防
アズカル	預かる
ヒッキ	筆記
ホキョウ	補強
バイウ	梅雨
ゲシャ	下車
ガイシャ	外車
キカンシャ	機関車
ジテンシャ	自転車
ジドウシャ	自動車
クルマ	車
シャナイ	車内
シャリョウ	車両
センシャ	戦車
デンシャ	電車
リンカ	隣家
キタカゼ	北風
ガヨウシ	画用紙
ジョユウ	女優
ユウショウ	優勝
ユウセン	優先
ギレイ	儀礼
クフウ	工夫
フジン	夫人
レイギ	礼儀
ドウソウカイ	同窓会
カイシュウ	回収
ツヨマル	強まる
シュウシ	収支
シュウニュウ	収入
シュウヨウ	収容
スイトウ	出納
ネンシュウ	年収
ビカ	美化
シュウシュウ	収集
ソナエル	供える
ケツダン	決断
コトワル	断る
ハンダン	判断
ヨダン	予断
シボル	絞る
ホド	程
ハナシコトバ	話し言葉
ナニカ	何か
ナント	何と
ナントカ	何とか
ナニヨリ	何より
ナントモ	何とも
ナンド	何度
ジンドウシュギ	人道主義
オソワル	教わる
ヤマノボリ	山登り
ミナミ	南
ナンブ	南部
ナンボク	南北
ナンセイ	南西
ナントウ	南東
カセキ	化石
ミョウネン	明年
ヒキトル	引取る
テアシ	手足
アシ	足
フソク	不足
ボウチョウ	膨張
ホッソク	発足
アシモト	足元
フクレル	膨れる
ワリニ	割に
チガイ	違い
イハン	違反
イホウ	違法
マチガイ	間違い
ソウイ	相違
リュウコウカ	流行歌
カイショウ	解消
タエル	耐える
ショウヒ	消費
ショウヒシャ	消費者
ショウボウ	消防
トリケシ	取り消し
オチコボレ	落ちこぼれ
サカイ	境
キョウカイ	境界
コッキョウ	国境
シンキョウ	心境
ツイトツ	追突
ツイデ	次いで
ウケツケル	受け付ける
カミ	神
シンケイ	神経
ジンジャ	神社
シンワ	神話
ミツカル	見付かる
イチバン	一番
バングミ	番組
ホンバン	本番
キセイ	規制
キテイ	規定
コウハク	紅白
シンキ	新規
セイキ	正規
ムショウニ	無性に
シュジュツ	手術
モウシワケ	申し訳
キセル	着せる
ホゴ	保護
ホゴシャ	保護者
ヒカル	光る
テンカイ	展開
テンジ	展示
ハッテン	発展
コロブ	転ぶ
ノリバ	乗り場
ヒトニギリ	一握り
ツナワタリ	綱渡り
マゼル	交ぜる
ジッタイ	実態
ジョウタイ	状態
タイセイ	態勢
タイド	態度
イケバナ	生け花
キキメ	利き目
ジタイ	事態
シドウ	指導
ハヤス	生やす
ドウニュウ	導入
ハンドウタイ	半導体
ソウシュン	早春
アクイ	悪意
ヨコガキ	横書き
ケンドウ	剣道
シンセン	新鮮
アザヤカ	鮮やか
ステキ	素敵
ツウジル	通じる
トバス	飛ばす
ワエイ	和英
ヒャッカジテン	百科事典
グンビ	軍備
セツビ	設備
ネンガ	年賀
ヨビ	予備
キゲン	機嫌
キラウ	嫌う
ジタク	自宅
ジュウタク	住宅
ジュウタクチ	住宅地
タクチ	宅地
カイスウケン	回数券
コウガイ	公害
ユウガイ	有害
リガイ	利害
ケハイ	気配
シハイ	支配
シンパイ	心配
ハイチ	配置
ハイトウ	配当
ハイブン	配分
ブンパイ	分配
カンビョウ	看病
ネンゴウ	年号
フクサヨウ	副作用
テスリ	手すり
アラワレ	現われ
ケイサン	計算
ケッサン	決算
ウカル	受かる
ヨサン	予算
シタジキ	下敷き
シテン	視点
シヤ	視野
ジュウシ	重視
ジュンカイ	巡回
シキブトン	敷き布団
スワル	座る
ジョウケン	条件
ジョウヤク	条約
カンジ	幹事
カンブ	幹部
コウキュウ	恒久
アオイ	青い
オオイ	多い
カナシム	悲しむ
ミキ	幹
ヒルマエ	昼前
ドクサイ	独裁
ドクジ	独自
ドクシン	独身
ドクトク	独特
ドクリツ	独立
ケイカン	警官
ケイコク	警告
ケイホウ	警報
ツミタテ	積み立て
タイセキ	体積
チャドウ	茶道
サドウ	茶道
ハンサヨウ	反作用
ムイミ	無意味
キュウメイ	究明
ケンキュウ	研究
ワリアテ	割当て
キョウイク	教育
クイチガイ	食違い
ミル	診る
タイイク	体育
ウケミ	受身
シュッセキ	出席
セキ	席
セキジョウ	席上
ウンユ	運輸
ユシュツ	輸出
ユソウ	輸送
ユニュウ	輸入
ヨウキ	陽気
タテナオス	立て直す
シタシラベ	下調べ
アラタマル	改まる
タズネル	訪ねる
ホウモン	訪問
タノシミ	楽しみ
コウラク	行楽
ココロヨイ	快い
カイセイ	快晴
コウサ	交差
サシアゲル	差し上げる
サイキ	再起
ジョウギ	定規
ナワ	縄
ソセン	祖先
チャクジツ	着実
キモノ	着物
ノリクミイン	乗組員
ジョウヨウシャ	乗用車
ケイロウ	敬老
シテン	支店
ショテン	書店
テンイン	店員
ホンテン	本店
ジュウタイ	重態
コウリテン	小売店
キジュツ	記述
アキチ	空地
トル	捕る
トラエル	捕らえる
ノコリ	残り
ザンギョウ	残業
ザンダカ	残高
サス	指す
ハバム	阻む
ノコス	残す
カンソウ	感想
コウソウ	構想
ササル	刺さる
シソウ	思想
ソンケイ	尊敬
ハッソウ	発想
ヨソウ	予想
リソウ	理想
アル	有る
シンカンセン	新幹線
セン	線
ムセン	無線
カクリツ	確率
カケル	駆ける
コクフク	克服
オル	織る
フブキ	吹雪
ヒリツ	比率
リリツ	利率
ソッチョク	率直
ワカワカシイ	若々しい
オサマル	治まる
オサメル	治める
ビョウイン	病院
ビョウキ	病気
ビョウシ	病死
シンダイ	寝台
デイリグチ	出入口
イッパイ	一杯
ケイド	経度
ノウカ	農家
ノウキョウ	農協
ノウギョウ	農業
ノウジョウ	農場
ノウソン	農村
ノウチ	農地
ノウミン	農民
タチドマル	立ち止まる
シュウ	州
タシザン	足し算
カクセイキ	拡声機
チョクシ	直視
ブリョク	武力
ナマイキ	生意気
コエ	声
セイメイ	声明
シツ	質
シツモン	質問
ヒトジチ	人質
セイシツ	性質
タイシツ	体質
ヒンシツ	品質
ブッシツ	物質
ホンシツ	本質
ハッパ	葉っぱ
キネン	記念
キネンビ	記念日
ザンネン	残念
シンネン	信念
ダンネン	断念
ニュウネン	入念
ウスグライ	薄暗い
リネン	理念
イレモノ	入れ物
バケモノ	化け物
キタイ	期待
シチヤ	質屋
ヤオヤ	八百屋
カエス	反す
キビン	機敏
ココロミ	試み
シアイ	試合
ニュウシ	入試
カゾク	家族
テビキ	手引
ヒキダス	引出す
ミンゾク	民族
アタイスル	値する
キショウ	気象
ギョソン	漁村
ゲンショウ	現象
タイショウ	対象
ダイベン	代弁
ギンコウ	銀行
ギン	銀
クイキ	区域
ジカツ	自活
チイキ	地域
リョウイキ	領域
エンジョ	援助
ガンコ	頑固
トリツグ	取り次ぐ
タスケル	助ける
ジョシュ	助手
ホジョ	補助
カロウ	過労
コウチャ	紅茶
アラス	荒らす
アレル	荒れる
オモイキル	思い切る
ジョウレイ	条例
ゼンレイ	前例
ヒレイ	比例
タトエバ	例えば
レイガイ	例外
レイネン	例年
レイ	例
エイセイ	衛生
ジエイ	自衛
ボウエイ	防衛
シゼン	自然
シュカンテキ	主観的
トウゼン	当然
ジョウジル	乗じる
ソウキ	早期
ソウチョウ	早朝
ハヤメル	早める
カメ	亀
シュチョウ	主張
シュッチョウ	出張
ハカル	計る
エイガ	映画
ジョウエイ	上映
アクジョ	悪女
キゲン	期限
ケンゲン	権限
カギル	限る
ゲンカイ	限界
ゲンテイ	限定
ゲンド	限度
サイショウゲン	最小限
セイゲン	制限
ツラナル	連なる
サイダイゲン	最大限
ハブラシ	歯ブラシ
オヤ	親
オヤコ	親子
シンゾク	親族
ジンブンカガク	人文科学
リョウシン	両親
キンガク	金額
スミ	炭
オモイガケナイ	思いがけない
カンシ	監視
イイダス	言い出す
ジョウシャケン	乗車券
オクレ	遅れ
カンキョウ	環境
ケイケン	経験
シケン	試験
ジッケン	実験
ジュケン	受験
タイケン	体験
ボクジョウ	牧場
ゴウジョウ	強情
ミスゴス	見過ごす
オウ	追う
ツイカ	追加
ツイホウ	追放
マズシイ	貧しい
マイド	毎度
ササヤカ	細やか
シンギ	審議
シンパン	審判
フシン	不審
ヨウショク	養殖
ナガラク	長らく
ショウギョウ	商業
ショウシャ	商社
ショウテン	商店
ショウバイ	商売
ショウヒン	商品
コトバ	言葉
アオザメル	青ざめる
ユカタ	浴衣
ウチアケル	打ち明ける
マッサオ	真っ青
イギ	意義
ギム	義務
キョウサンシュギ	共産主義
シホンシュギ	資本主義
シュギ	主義
セイギ	正義
ヒルネ	昼寝
テイギ	定義
メイギ	名義
ツタワル	伝わる
デンセツ	伝説
デントウ	伝統
アミモノ	編み物
チャワン	茶わん
キュウコウ	休校
ハタラキ	働き
ロウドウシャ	労働者
ロウドウ	労働
カタチ	形
ケイシキ	形式
ケイセイ	形成
テガタ	手形
ニンギョウ	人形
タダス	正す
ケイキ	景気
クイチガウ	食い違う
トム	富む
オチル	落ちる
カキナオス	書き直す
セイオウ	西欧
チョクシン	直進
トウオウ	東欧
ヒジョウシキ	非常識
トビオリル	飛び降りる
タスカル	助かる
カンヌシ	神主
タントウ	担当
タンニン	担任
タンポ	担保
ブンタン	分担
コノミ	好み
コウイ	好意
コウチョウ	好調
コウブツ	好物
ダイスキ	大好き
カッコウ	格好
インタイ	引退
カイラク	快楽
サシダス	差し出す
タイジ	退治
タイショク	退職
チュウタイ	中退
ロウドク	朗読
ジュンビ	準備
ジョウタツ	上達
スイジュン	水準
キジュン	基準
コウザン	鉱山
ショウ	賞
ショウキン	賞金
ニュウショウ	入賞
カタガワ	片側
キソ	起訴
アラワレル	表れる
ウッタエ	訴え
ハヤマル	早まる
ヘン	辺
オオウ	覆う
カイゾウ	改造
コウゾウ	構造
クミタテル	組み立てる
モクゾウ	木造
エイゴ	英語
ヒトミシリ	人見知り
ユキドケ	雪解け
ヒガイ	被害
ヒコク	被告
フシマツ	不始末
カブ	株
カブシキ	株式
カブヌシ	株主
カンカク	間隔
ツユアケ	梅雨明け
ダボク	打撲
ネントウ	念頭
セントウ	先頭
カザカミ	風上
エンギ	演技
ワザ	技
ギジュツ	技術
ギノウ	技能
シュクフク	祝福
トックン	特訓
サイテイ	最低
テイカ	低下
ゲンソ	元素
モトモト	本々
マイニチ	毎日
アビセル	浴びせる
イガク	医学
イシャ	医者
キンシ	近視
コジ	故事
カイフク	回復
シソン	子孫
ウチキ	内気
フッカツ	復活
オバケ	お化け
シゴト	仕事
ニュウジ	乳児
ハセイ	派生
フカカイ	不可解
シカタ	仕方
シクミ	仕組み
ジモン	自問
カコ	過去
キョネン	去年
シキョ	死去
メイズル	命ずる
カンショウ	鑑賞
スガタ	姿
シセイ	姿勢
ハンコウ	反抗
イミ	意味
キミ	気味
ジミ	地味
アジ	味
ミカタ	味方
タダ	唯
カタミ	形見
ショウブ	勝負
マケ	負け
フタン	負担
アトガキ	後書き
ソカク	組閣
ナイカク	内閣
スルドイ	鋭い
ミナリ	身なり
ニッカン	日韓
ミズイロ	水色
チャクショク	着色
ナンイ	難易
カシツ	過失
チカヅケル	近付ける
スコヤカ	健やか
ウシナウ	失う
シツギョウ	失業
テッキョウ	鉄橋
モウレツ	猛烈
イテン	移転
イドウ	移動
イミン	移民
カクサ	格差
クチベニ	口紅
サベツ	差別
ウケル	請ける
モノサシ	物差し
コウヨウ	紅葉
キカン	器官
ゲンコウヨウシ	原稿用紙
ゴサ	誤差
シュウギイン	衆議院
タイシュウ	大衆
チョウジョウ	頂上
ミンシュウ	民衆
カタマリ	塊
ヨコガオ	横顔
コジン	個人
コセイ	個性
アサガオ	朝顔
ココ	個々
カタサ	硬さ
セイモン	正門
ゾンジル	存じる
ニュウモン	入門
ブモン	部門
メイモン	名門
クワダテル	企てる
ゲッショク	月食
シャシン	写真
ジンゾウ	人造
ヒョウ	評
ヒョウカ	評価
ヒョウバン	評判
ヒョウロン	評論
ハゲマス	励ます
アクジ	悪事
カゼイ	課税
カダイ	課題
カチョウ	課長
ニッカ	日課
サガス	探す
アトシマツ	後始末
ネンマツ	年末
マッキ	末期
マモル	守る
シュビ	守備
ホシュ	保守
ギャッキョウ	逆境
キンギョ	金魚
ワカモノ	若者
カガヤカシイ	輝かしい
クチダシ	口出し
シュノウ	首脳
ノウ	脳
ノウシ	脳死
リコウ	利口
エキ	液
ショウキョクテキ	消極的
ナンキョク	南極
イッシュ	一種
シュモク	種目
ジンシュ	人種
ナゲル	投げる
ヒンシュ	品種
ウツクシイ	美しい
ビジュツ	美術
ヒニン	避妊
ウデマエ	腕前
ハナシゴエ	話し声
ミジカイ	短い
カゲ	影
ウンメイ	運命
カクメイ	革命
シメイ	使命
シンセイ	神聖
セイメイ	生命
ニンメイ	任命
ネムリ	眠り
イノチ	命
メイニチ	命日
ダンセイテキ	男性的
モノオト	物音
ツカイステ	使い捨て
コウキシン	好奇心
モウシデル	申し出る
ガマン	我慢
カサナル	重なる
オオクラ	大蔵
ネンリン	年輪
ヤスイ	安い
オヨボス	及ぼす
ジュウリョウ	重量
スウリョウ	数量
タイリョウ	大量
チュウドク	中毒
キエル	消える
テンボウ	展望
ノゾミ	望み
ヨウボウ	要望
ウチケシ	打ち消し
オモイナオス	思い直す
マツ	松
ハメツ	破滅
ヒナン	非難
ヒジョウ	非常
ダゲキ	打撃
ハンゲキ	反撃
モクゲキ	目撃
サシツカエル	差し支える
バンネン	晩年
ナラブ	並ぶ
サシツカエ	差し支え
ホサ	補佐
カク	核
ケッカク	結核
ネッスル	熱する
ハクネツ	白熱
ホウガイ	法外
チュウカク	中核
サケブ	叫ぶ
カンサツ	観察
ケイサツ	警察
ツキハジメ	月初め
ケンサツ	検察
アラワス	表わす
シサツ	視察
シサ	示唆
セイビ	整備
セイリ	整理
チョウセイ	調整
イチダン	一段
シュダン	手段
ウツス	映す
ヒキハナス	引き離す
ヨコ	横
オウダン	横断
キンユウ	金融
シジュウ	始終
カタ	型
オオガタ	大型
コガタ	小型
メイハク	明白
イップウ	一風
オドス	脅す
クウハク	空白
コクメイ	克明
シロ	白
ハクショ	白書
ハクジン	白人
カザシモ	風下
ボクメツ	撲滅
オボエル	覚える
カツジ	活字
アラワス	現わす
スウジ	数字
モジドオリ	文字通り
チョッケイ	直径
カイトウ	回答
コタエ	答え
モンドウ	問答
ヒマ	暇
オイツク	追い付く
セイサン	成算
モリアゲル	盛り上げる
ゼンヤ	前夜
ヤワラカ	柔らか
ヨル	夜
ヤカン	夜間
セイサク	製作
セイゾウ	製造
セイヒン	製品
トウヒョウ	投票
ヒョウ	票
コノハ	木の葉
ジョウキョウ	状況
フキョウ	不況
ヤクダツ	役立つ
オンガク	音楽
オンセイ	音声
キンキョリ	近距離
ケツエン	血縁
フソウオウ	不相応
ホンネ	本音
シンコク	申告
トウシン	答申
ツメタイ	冷たい
ワリアテル	割り当てる
カミサマ	神様
タヨウ	多様
ドウヨウ	同様
フクラム	膨らむ
ヨウス	様子
ヨウシキ	様式
ヨウソウ	様相
サマザマ	様々
ザイカイ	財界
ザイサン	財産
ザイセイ	財政
ブンカザイ	文化財
チカラモチ	力持ち
クウコウ	空港
ミナト	港
ショウガクキン	奨学金
ヤセイ	野性
イシキ	意識
ジョウシキ	常識
チシキ	知識
ニンシキ	認識
ツッパル	突っ張る
ムカシバナシ	昔話
チュウイ	注意
チュウモン	注文
チュウモク	注目
ヨブ	呼ぶ
アユミヨル	歩み寄る
コウショウ	交渉
ヒヨリ	日和
ジョウヒン	上品
タッセイ	達成
ツウタツ	通達
カイリョウ	改良
フリョウ	不良
リョウコウ	良好
エイキョウ	影響
マエオキ	前置き
ハンキョウ	反響
イチイチ	一々
ノリモノ	乗物
ヘイキ	平気
カエリ	帰り
キコク	帰国
キタク	帰宅
シヌ	死ぬ
シニン	死人
フッキ	復帰
ベンジョ	便所
ヨコギル	横切る
ハリ	針
ホウシン	方針
センム	専務
センモン	専門
センモンカ	専門家
センヨウ	専用
スイシン	推進
スイテイ	推定
トオカ	十日
シロバイ	白バイ
ハクセン	白線
タチナオル	立ちなおる
タニ	谷
コダイ	古代
キコウ	気候
モト	本
ホン	本
コウホ	候補
アキカゼ	秋風
オオモジ	大文字
リッコウホ	立候補
ナサケナイ	情けない
シジョウ	史上
ウケモツ	受け持つ
トグ	研ぐ
イノリ	祈り
ザシキ	座敷
テン	天
テンジョウ	天井
テンキ	天気
テンコウ	天候
テンゴク	天国
テンネン	天然
カイ	階
カイダン	階段
ゲンシュ	厳守
ダンカイ	段階
ニカイ	二階
ホウニン	放任
カテイ	課程
カテイ	過程
カネル	兼ねる
ギョウギ	行儀
タンショ	短所
テイド	程度
ニッテイ	日程
コノハ	木ノ葉
セイジュク	成熟
フマン	不満
マンイン	満員
マンゾク	満足
シッパイ	失敗
ショウハイ	勝敗
ハイセン	敗戦
ハイボク	敗北
ウンキュウ	運休
カンリ	管理
ショウジ	障子
ソクセキ	即席
ホカン	保管
カン	管
クダ	管
カチ	価値
スウチ	数値
アラウ	洗う
タリル	足りる
タイホウ	大砲
アタイ	値
ネアゲ	値上げ
ネサゲ	値下げ
ネダン	値段
スエオキ	据え置き
カシュ	歌手
ウラナウ	占う
ヒマン	肥満
ヒリョウ	肥料
ショウリョウ	小量
カウ	買う
バイシュウ	買収
バイバイ	売買
カイモノ	買い物
ノリオリ	乗り降り
ダンボウ	暖房
トツゼン	突然
ニセモノ	偽物
イキワタル	行き渡る
ホコル	誇る
ノビル	延びる
ダイズ	大豆
トウフ	豆腐
ナットウ	納豆
ウツル	移る
テスウ	手数
スイコウ	遂行
セッスル	接する
セッキン	接近
セッタイ	接待
チョクセツ	直接
バンチ	番地
メンセツ	面接
タイハイ	退廃
カクスウ	画数
シンセイ	申請
セイキュウ	請求
メイロウ	明朗
ヨウセイ	要請
カクヘイキ	核兵器
ガッキ	楽器
キショウ	起床
ブキ	武器
ヘイキ	兵器
ヨウキ	容器
ジョウブ	丈夫
コウギョウ	鉱業
ドウシ	同士
ヘイシ	兵士
カンコウ	観光
ヒカリ	光
コウケイ	光景
セイサン	精算
ケントウ	検討
トウギ	討議
トウロン	討論
シンロ	進路
センロ	線路
ホウムル	葬る
ドウロ	道路
ロジョウ	路上
アク	悪
アッカ	悪化
アクシツ	悪質
サイアク	最悪
メザス	目指す
カガク	科学
カガクシャ	科学者
ゲカ	外科
ガッカ	学科
キョウカショ	教科書
センネン	専念
ブンカ	文科
リカ	理科
カモク	科目
キャクシャ	客車
セメル	攻める
コウゲキ	攻撃
シュエイ	守衛
センコウ	専攻
タイテイ	大抵
カントク	監督
イワウ	祝う
キョウジュ	教授
ジュギョウ	授業
ジョキョウジュ	助教授
チカク	知覚
ハンケイ	半径
カイサイ	開催
シュサイ	主催
ウム	産む
コマカイ	細かい
メイサイ	明細
コウカ	効果
コウリツ	効率
ムコウ	無効
ユウコウ	有効
ヨウフウ	洋風
イト	意図
ズケイ	図形
トショ	図書
チズ	地図
コンシュウ	今週
シュウ	週
シュウマツ	週末
ショウダク	承諾
センシュウ	先週
マイシュウ	毎週
ライシュウ	来週
インカン	印鑑
セッキョクテキ	積極的
メンセキ	面積
カミナリ	雷
ヒノマル	日の丸
サメル	冷める
ヒケメ	引け目
タホウ	他方
タニン	他人
カン	勘
カンジョウ	勘定
オヨブ	及ぶ
ツイキュウ	追及
ラクダイ	落第
ワン	湾
キロク	記録
ムショク	無色
ロクオン	録音
ショチ	処置
ショブン	処分
ショリ	処理
タイショ	対処
カツグ	担ぐ
ツウレツ	痛烈
テンサイ	天才
ヒジョウグチ	非常口
ツケクワエル	付け加える
オトズレル	訪れる
メツキ	目付き
ミカケ	見かけ
ガイムショウ	外務省
オオクラショウ	大蔵省
ハンセイ	反省
モンブショウ	文部省
ツウサンショウ	通産省
ナイ	無い
キョウシツ	教室
シツナイ	室内
タイトク	体得
マワリ	回り
ケンポウ	憲法
センサイ	繊細
オクレ	後れ
カショ	個所
ムシバ	虫歯
ノリキ	乗気
ウッタエル	訴える
フトイ	太い
コウメイ	高名
ハシ	橋
ケイシャ	傾斜
ジュウジロ	十字路
シンポ	進歩
ホチョウ	歩調
ダンダン	段々
ヨコミチ	横道
ブンリ	分離
ハナレル	離れる
ニクイ	難い
カタイ	難い
ソウジキ	掃除機
ヒダリキキ	左利き
カイガン	海岸
キシ	岸
セントウ	銭湯
マス	増す
リュウネン	留年
カンキャク	観客
キャク	客
キャッカンテキ	客観的
キャクセキ	客席
ケンオ	嫌悪
タイケイ	体型
オギナウ	補う
メジルシ	目印
ジョウキャク	乗客
オセジ	お世辞
キョウフウ	強風
ハクジョウ	白状
フウケイ	風景
ソッセン	率先
タイフウ	台風
カミ	紙
シメン	紙面
テガミ	手紙
トダエル	途絶える
ハクシ	白紙
ヒョウシ	表紙
ヨウシ	用紙
キュウゲキ	急激
ゲキドウ	激動
チュウサンカイキュウ	中産階級
ハクランカイ	博覧会
ヒテイ	否定
ヒンジャク	貧弱
オイツク	追いつく
ホソナガイ	細長い
シュウヘン	周辺
メグリアウ	巡り会う
マワリ	周り
メダマショウヒン	目玉商品
イシ	医師
ギシ	技師
キョウシ	教師
ハナス	放す
オシツケル	押し付ける
シテキ	指摘
テキハツ	摘発
ハクイ	白衣
ザイリョウ	材料
シュザイ	取材
シンアイ	親愛
ジンザイ	人材
モクザイ	木材
カワイイ	可愛い
ナス	成す
ツモル	積もる
マチアワセル	待ち合わせる
トウコウ	登校
トザン	登山
トウジョウ	登場
トウロク	登録
ダイダイ	代代
ケイトウ	系統
タイケイ	体系
テッポウ	鉄砲
ヒハン	批判
ヒヒョウ	批評
テイケイ	定形
スジミチ	筋道
ヒトチガイ	人違い
ナンカ	軟化
オカアサン	お母さん
ハハ	母
ハハオヤ	母親
オロシウリ	卸売
アンイ	安易
コウフン	興奮
コウスイ	降水
ヨウイ	容易
ナオル	直る
トウサン	父さん
ノベ	延べ
ケンゼン	健全
トウジョウ	搭乗
ホケン	保健
クロ	黒
クロジ	黒字
コクジン	黒人
ミョウチョウ	明朝
カザン	火山
カジ	火事
ホウカ	放火
イド	井戸
カタイ	固い
コワイ	怖い
エイセイテキ	衛生的
カソク	加速
カイタク	開拓
キュウソク	急速
ゲンソク	減速
コウソク	高速
コウソクドウロ	高速道路
ジソク	時速
スミヤカ	速やか
ソクド	速度
フウソク	風速
セイゾン	生存
ソンザイ	存在
ホゾン	保存
キョウゾン	共存
ハナ	花
ハナビ	花火
テンプク	転覆
リッキャク	立脚
カエル	帰る
ハル	春
ヒソム	潜む
ブアイ	歩合
シカクイ	四角い
トオス	通す
ニュウカ	入荷
ヒコウ	飛行
ヒコウキ	飛行機
ソノホカ	その外
コロス	殺す
サツジン	殺人
ジサツ	自殺
タイヒ	退避
フシンセツ	不親切
セイソウ	正装
チュウオウ	中央
チル	散る
ショウケン	証券
シンズル	信ずる
アカチャン	赤ちゃん
アカジ	赤字
コナ	粉
ナオス	治す
クチドメ	口止め
シンゴウ	信号
サカズキ	杯
バンゴウ	番号
クジラ	鯨
タンナル	単なる
タンニ	単に
タンイ	単位
タンイツ	単一
カメイ	加盟
ラクテンテキ	楽天的
モリアガル	盛り上がる
チュウショウテキ	抽象的
ドウメイ	同盟
アンモク	暗黙
ザセキ	座席
アンセイ	安静
アオ	青
セイシュン	青春
セイネン	青年
ケンブツニン	見物人
トッパ	突破
ハサン	破産
アタリ	当り
アタリマエ	当り前
ヘンセイ	編成
テアテ	手当て
ヘンシュウ	編集
ソウサ	捜査
ヒヤカス	冷やかす
フトコロ	懐
タケ	竹
カイジョ	解除
ベンサイ	弁済
カンセイ	完成
カンゼン	完全
スム	住む
テキリョウ	適量
シュジン	主
オモ	主
シュ	主
ヌシ	主
カイテ	買手
ズイヒツ	随筆
オリル	降りる
ガンバル	頑張る
ネツレツ	熱烈
モクジ	目次
オリル	下りる
ツキアウ	付き合う
ニナウ	担う
ヒキツケル	引き付ける
セキニン	責任
コンドウ	混同
クギル	区切る
イリョウ	医療
チリョウ	治療
ツッコム	突っ込む
カイバツ	海抜
カオツキ	顔付き
ジュウギョウイン	従業員
ジュウライ	従来
サッソク	早速
フジチャク	不時着
チャクチャク	着々
ミギ	右
ミギテ	右手
ノリマワス	乗り回す
トウワク	当惑
シュウセイ	修正
シュウリ	修理
マジル	交じる
ミセビラキ	店開き
シュンブン	春分
ミクラベル	見比べる
イジワル	意地悪
グンタイ	軍隊
ジエイタイ	自衛隊
ナガレル	流れる
キムズカシイ	気難しい
キキ	危機
ソウサイ	相殺
ボウエンキョウ	望遠鏡
サイケツ	採決
サイサン	採算
サイヨウ	採用
テオクレ	手遅れ
ソシキ	組織
モリ	森
ツウチョウ	通帳
クイ	悔い
キョウギ	競技
キョウソウ	競争
サズケル	授ける
カクダイ	拡大
グンカク	軍拡
コウツウジコ	交通事故
ジコ	事故
エイガカン	映画館
オンタイ	温帯
ヒサシイ	久しい
グンカン	軍艦
トショカン	図書館
タイシカン	大使館
ビジュツカン	美術館
シアゲル	仕上げる
シカタガナイ	仕方がない
フシン	不振
ザットウ	雑踏
キュウショク	給食
キュウヨ	給与
キュウリョウ	給料
キョウキュウ	供給
ホキュウ	補給
ミジュク	未熟
オクジョウ	屋上
ノキ	軒
コヤ	小屋
ヘヤ	部屋
サガス	捜す
オン	恩
ヨミ	読み
ヨミカタ	読み方
ドクシャ	読者
ドクショ	読書
シモン	指紋
モッテイク	持って行く
トウベン	答弁
ベンゴ	弁護
ベンゴシ	弁護士
ベントウ	弁当
ヒトリジメ	独り占め
ヤネ	屋根
コンポン	根本
ネモト	根本
ワズラウ	患う
イロ	色
ワタル	渡る
トクショク	特色
キョウドウ	協同
トモ	友
ユウコウ	友好
ユウジョウ	友情
ユウジン	友人
トモダチ	友達
コエル	超える
トリシラベ	取調べ
クルシミ	苦しみ
ニガテ	苦手
クジョウ	苦情
クロウ	苦労
サス	差す
シュウショク	就職
シュウニン	就任
マイバン	毎晩
ハクハツ	白髪
シラガ	白髪
ナミ	並
コウネツヒ	光熱費
ハジ	恥
サケビ	叫び
コウブツ	鉱物
ハシル	走る
ハンバイ	販売
ソノ	園
エン	園
ガクエン	学園
コウエン	公園
ハズム	弾む
ドウブツエン	動物園
カグ	家具
カオブレ	顔触れ
グタイテキ	具体的
ドウグ	道具
グアイ	具合
ツカマエル	捕まえる
ヒダリ	左
サユウ	左右
ヒダリテ	左手
ホウガク	方角
ミンヨウ	民謡
イジョウ	異常
ゲンゾウ	現像
ガクレキ	学歴
ケイレキ	経歴
ケワシイ	険しい
オモワク	思わく
ソントク	損得
レキシ	歴史
レキシテキ	歴史的
ジショ	辞書
ジショク	辞職
ジニン	辞任
ショウグン	将軍
ショウライ	将来
ハナシアイ	話合い
キソウ	競う
マガル	曲がる
アキ	秋
ヘイオン	平穏
ボットウ	没頭
ゲンイン	原因
サイキン	細菌
フキツ	不吉
ヨウイン	要因
センテンテキ	先天的
ウラオモテ	裏表
ゲンジュウ	厳重
カキネ	垣根
ケイバ	競馬
ウマ	馬
アイ	愛
アイジョウ	愛情
エントツ	煙突
オオハバ	大幅
チコク	遅刻
ハバ	幅
ハバヒロイ	幅広い
テツヅキ	手続
ミツモリ	見積り
ヤスミ	休み
ヤスム	休む
キュウギョウ	休業
キュウジツ	休日
レンキュウ	連休
シュウキュウ	週休
イジ	維持
イシン	維新
カイギ	懐疑
カンヅメ	缶詰
キモ	肝
キョウグウ	境遇
アツイ	厚い
カンメイ	感銘
タナ	棚
トミ	富
ハカル	量る
セイケツ	清潔
ハマ	浜
オトウサン	お父さん
ツキアタル	突き当たる
チチ	父
チチオヤ	父親
フボ	父母
イサン	遺産
イタイ	遺体
カシャ	貨車
トリアゲル	取上げる
ヨセアツメ	寄せ集め
キセイ	寄生
ミグルシイ	見苦しい
カレラ	彼ら
カノジョ	彼女
イッパン	一般
エキチョウ	駅長
シュウチャクエキ	終着駅
ゼンパン	全般
ソウタイ	早退
ムノウ	無能
ヒョウザン	氷山
ミテイ	未定
ミメイ	未明
ミライ	未来
ムダ	無駄
ハナシコム	話し込む
ソクタツ	速達
チャクセキ	着席
ボウエキ	貿易
オモウゾンブン	思う存分
カンデンチ	乾電池
コウエン	講演
コウギ	講義
コウシ	講師
コウワ	講和
ナナメ	斜め
ノベル	述べる
ホウジン	邦人
レンポウ	連邦
ウム	生む
ハエル	映える
ヨコタワル	横たわる
ヨコドリ	横取り
ミマウ	見舞う
ノビヤカ	伸びやか
ブタイ	舞台
キンズル	禁ずる
シンリン	森林
ネットウ	熱湯
ノウリン	農林
ハヤシ	林
ソウチ	装置
ブソウ	武装
テイガク	停学
ロウニン	浪人
ナツ	夏
ナツヤスミ	夏休み
ソザイ	素材
シロウト	素人
スナオ	素直
ネンド	粘土
ヨウソ	要素
シボウ	死亡
ボウメイ	亡命
エンゲキ	演劇
エンソク	遠足
ゲキ	劇
ゲキジョウ	劇場
ゲキテキ	劇的
ツキヨ	月夜
ソメル	染める
カセン	河川
カワグチ	河口
カコウ	河口
セイザ	正座
ハケン	派遣
アトモドリ	後戻り
コウカイ	航海
コウクウ	航空
コウクウキ	航空機
コムギ	小麦
ナンコウ	難航
ムギ	麦
フミン	不眠
コウギ	抗議
タイコウ	対抗
オジ	伯父
キュウガク	休学
シツド	湿度
レイスイ	冷水
レイセン	冷戦
オンガエシ	恩返し
キボ	規模
ドソク	土足
モヨウ	模様
アリサマ	有様
エイユウ	英雄
ショウドク	消毒
オス	雄
サイテキ	最適
テキセツ	適切
テキトウ	適当
テキヨウ	適用
ムボウ	無謀
モチナオス	持直す
シュフ	主婦
フジン	婦人
フウフ	夫婦
ナグル	殴る
キメツケル	決め付ける
コクテツ	国鉄
シテツ	私鉄
チカテツ	地下鉄
テツ	鉄
テツドウ	鉄道
ヒキシメル	引き締める
ハオリ	羽織
ヨセル	寄せる
チンレツ	陳列
キフ	寄付
トシヨリ	年寄り
カタイ	堅い
メイチョ	名著
リエキ	利益
モチコム	持ち込む
オイコム	追い込む
イソガシイ	忙しい
ミコミ	見込み
モウシコミ	申し込み
カオ	顔
キョウツウゴ	共通語
ソボク	素朴
カンダイ	寛大
キンキュウ	緊急
キンチョウ	緊張
サンミャク	山脈
ドウミャク	動脈
マナコ	眼
ミハル	見張る
シュルイ	種類
ショルイ	書類
シンルイ	親類
ジンルイ	人類
イタマシイ	痛ましい
イクジ	育児
ツクル	造る
キヨラカ	清らか
カネテ	予て
ヨチ	余地
ミカギル	見限る
キンシ	禁止
フウトウ	封筒
ミナライ	見習い
シルシ	印
インショウ	印象
ヘダテル	隔てる
ケンキョ	謙虚
チョウイン	調印
ケシイン	消印
トル	採る
ムカイ	向かい
ギャク	逆
オウコク	王国
オウジ	王子
オウジャ	王者
オウジョ	王女
キュウショ	急所
キョウシュク	恐縮
ジョオウ	女王
フンマツ	粉末
イチガイニ	一概に
ヘンサイ	返済
ヘンジ	返事
ヘントウ	返答
メザメル	目覚める
メザマシドケイ	目覚まし時計
ヒョウゴ	標語
ヒョウジュン	標準
カンポウヤク	漢方薬
コウカン	交換
コウミョウ	巧妙
ジュウゾク	従属
ヘンカン	変換
ノリカエ	乗り換え
メモリ	目盛り
ヒサシブリ	久しぶり
セイヨウジン	西洋人
ヨウマ	洋間
ヨウサイ	洋裁
タンカ	短歌
タンキ	短期
タンダイ	短大
ゲンユ	原油
セキユ	石油
アブラ	油
ユデン	油田
ニッキュウ	日給
ツマ	妻
テツダウ	手伝う
フサイ	夫妻
カワル	代わる
タダヨウ	漂う
ボウドウ	暴動
ボウリョク	暴力
ジカンワリ	時間割
ヒキウケル	引受ける
ヒトエ	一重
センリョウ	占領
ドクセン	独占
カイシメル	買い占める
センゲン	宣言
センデン	宣伝
テキスル	適する
テオチ	手落ち
ヤサシイ	易しい
ザンコク	残酷
セイ	背
ハイケイ	背景
セナカ	背中
ショウワ	昭和
アブラ	脂
ニアウ	似合う
トリヨセル	取り寄せる
デンタク	電卓
ハイシ	廃止
モノズキ	物好き
イショク	移植
ヒキオコス	引き起す
ワリキル	割り切る
オキアガル	起き上がる
サクリャク	策略
ショウリャク	省略
ショクブツ	植物
ショクミンチ	植民地
リャクゴ	略語
マチナミ	町並
コウネツ	高熱
ジョウネツ	情熱
ネツ	熱
ネツイ	熱意
ネッキ	熱気
ネッシン	熱心
ハツネツ	発熱
ガッシュク	合宿
ヤド	宿
ヌカス	抜かす
イヤクヒン	医薬品
グウゼン	偶然
ザブトン	座布団
セイヤク	製薬
クスリ	薬
ヤクヒン	薬品
オソレ	恐れ
クズス	崩す
アシアト	足跡
ソウナン	遭難
アクヨウ	悪用
キゲン	紀元
セイサン	清算
タンキュウ	探究
アリガタイ	有り難い
アマス	余す
シリアイ	知合い
エンシュウ	演習
ガクシュウ	学習
トウヒ	逃避
カブル	被る
キケン	危険
ケンアク	険悪
ホケン	保険
ユルム	緩む
クウシャ	空車
ヤメル	辞める
シンライ	信頼
タノム	頼む
カクリョウ	閣僚
カンリョウ	官僚
カンカク	感覚
ゲンゴウ	元号
ジカク	自覚
ハッカク	発覚
ボウチョウ	傍聴
エンポウ	遠方
ジャマ	邪魔
サカリ	盛り
サカン	盛ん
ダン	壇
ホソウ	舗装
ヒキカエ	引換え
ケッショウ	結晶
センチョウ	船長
ゾウセン	造船
フネ	船
ウンパン	運搬
シタテル	仕立てる
バイ	倍
バイリツ	倍率
ナニブン	何分
ニル	煮る
モノサシ	物指
モノサシ	物指し
ヘイキン	平均
ミガル	身軽
サカサ	倒さ
スミ	墨
アソブ	遊ぶ
マルメル	丸める
ゼント	前途
マヨウ	迷う
ヨウト	用途
トチュウ	途中
アツリョク	圧力
キアツ	気圧
スエル	据える
タス	足す
オノオノ	各各
ソレゾレ	各各
ヒキガネ	引金
ヒキツヅキ	引続き
ハナビラ	花弁
オヨビ	及び
ゲイジュツ	芸術
ゲイノウ	芸能
コウゲイ	工芸
ハクアイ	博愛
ブンゲイ	文芸
ショクチュウドク	食中毒
ユルス	許す
キョカ	許可
トッキョ	特許
ウチケス	打消す
テンノウ	天皇
コス	超す
ミウシナウ	見失う
リンジ	臨時
トウカ	等価
ヒョウシ	拍子
エキ	駅
エキマエ	駅前
カミノケ	髪の毛
エンカイ	宴会
ショメイ	署名
ヌケダス	抜け出す
シメル	閉める
ハカイ	破壊
ムヨク	無欲
クイトメル	食止める
フサイ	負債
フクメン	覆面
ベンリ	便利
ツツミ	包み
ホウタイ	包帯
シカク	四角
トブ	飛ぶ
ノビ	伸び
ハナヨメ	花嫁
アブナイ	危ない
ザイリュウ	在留
カネ	鐘
ヨシュウ	予習
カラム	絡む
リュウガク	留学
リュウガクセイ	留学生
ツミ	罪
ムザイ	無罪
ユウザイ	有罪
ヨゴレル	汚れる
ヨワマル	弱まる
ヨワメル	弱める
チョウテイ	調停
テイシ	停止
フウリュウ	風流
ムガイ	無害
キョウミ	興味
シンコウ	振興
シンコウ	新興
ヘンキャク	返却
ゲンバク	原爆
チンボツ	沈没
バクゲキ	爆撃
バクハツ	爆発
ナイマク	内幕
ウチマク	内幕
キワマル	極まる
トタン	途端
ジョウリク	上陸
タイリク	大陸
チャクリク	着陸
リク	陸
リクグン	陸軍
リクジョウ	陸上
タマ	玉
オリカエシ	折り返し
ハイゾク	配属
メダマ	目玉
ウラドオリ	裏通り
ミナモト	源
シゲン	資源
ヨウシキ	洋式
ギシキ	儀式
ドロボウ	泥棒
テイセイ	訂正
デンパ	電波
ナミ	波
フクシャ	複写
マンジョウ	満場
ソウサク	創作
ソウゾウ	創造
ソウリツ	創立
ワカラズヤ	分からず屋
コショウ	故障
ワタシタチ	私たち
ショウガイ	障害
ケイゾク	継続
ウケツグ	受け継ぐ
チュウケイ	中継
ヒカゲ	日陰
スジ	筋
アトガキ	後書
カサ	傘
ネライ	狙い
イッタイ	一帯
セタイ	世帯
チタイ	地帯
ネッタイ	熱帯
フジョ	婦女
ナフダ	名札
レンタイ	連帯
エンキ	延期
エンチョウ	延長
ノゾム	臨む
リンジュウ	臨終
チカヨル	近寄る
コゲル	焦げる
ハネ	羽
ツトメル	努める
ジュンカン	循環
ドリョク	努力
キヨウ	器用
カタメル	固める
コテイ	固定
コユウ	固有
マンビキ	万引
ヒエコム	冷え込む
セントウ	戦闘
トウソウ	闘争
ニッソ	日ソ
セイシン	精神
キソク	規則
カンパイ	乾杯
カイ	会
フナビン	船便
キガエ	着替え
トウユ	灯油
タイシタ	大した
タイシテ	大して
ダッセン	脱線
フキュウ	普及
フダン	普段
フツウ	普通
カイサン	解散
サンポ	散歩
シカイ	司会
フツカ	二日
ハツカ	二十日
エンピツ	鉛筆
ケンコウ	健康
カンソク	観測
ソクテイ	測定
ユタカ	豊か
ホウフ	豊富
カイヨウ	海洋
セイヨウ	西洋
トウヨウ	東洋
ミッカ	三日
シズカ	静か
レイセイ	冷静
カイゼン	改善
カルイ	軽い
ゼン	善
タイホ	逮捕
アム	編む
ケッコン	結婚
シッケ	湿気
テイキュウビ	定休日
リコン	離婚
ハタチ	二十歳
ヨロコビ	喜び
ネンレイ	年齢
カコム	囲む
シキュウ	至急
シュウイ	周囲
セオウ	背負う
コス	越す
ソツギョウ	卒業
ツキ	月
トウブン	等分
セマル	迫る
ショウニン	承認
オジ	叔父
カタイ	硬い
クスリユビ	薬指
ハリキル	張り切る
クズレル	崩れる
カエス	帰す
ジュン	順
ジュンチョウ	順調
ナマ	生
ハエル	生える
ショウズル	生ずる
ウマレル	生まれる
ウマレ	生まれ
セイキ	世紀
チョッカク	直角
イツカ	五日
ジシュウ	自習
フクシュウ	復習
コノアイダ	この間
タビ	旅
リョカン	旅館
リョコウ	旅行
ゼッタイ	絶対
イリグチ	入口
ソノウエ	その上
コウキュウ	高級
ジョウキュウ	上級
ケンビキョウ	顕微鏡
フコウ	不幸
シアワセ	幸せ
イワ	岩
モノ	者
レンシュウ	練習
オス	押す
フル	振る
オサエル	押さえる
シズマル	静まる
タオレル	倒れる
メンドウ	面倒
イチ	市
シュウリョウ	終了
オクサマ	奥様
カンチョウ	官庁
ケンチョウ	県庁
セイホウケイ	正方形
コクモツ	穀物
ハクブツカン	博物館
シロ	城
モメン	木綿
カンジャ	患者
ヨッカ	四日
ハレル	晴れる
キリ	霧
ミツケル	見付ける
コウトウ	高等
ニル	似る
ビョウドウ	平等
キュウジョ	救助
イマニモ	今にも
マジル	混じる
ウケタマワル	承る
モウシコム	申し込む
トビコム	飛び込む
イッソウ	一層
コウソウ	高層
サイナン	災難
シュッパン	出版
ロウジン	老人
マザル	交ざる
メイレイ	命令
カクド	角度
ココノカ	九日
コトナル	異なる
ヒノイリ	日の入り
イレル	入れる
レンラク	連絡
ソン	損
ソンガイ	損害
ニョウボウ	女房
テイリュウジョ	停留所
タテル	立てる
ボシュウ	募集
サッキョク	作曲
クツシタ	靴下
シハラウ	支払う
ダイガクセイ	大学生
ケズル	削る
シバル	縛る
カテイ	家庭
ニワ	庭
オカワリ	お代わり
ハイイロ	灰色
アケル	明ける
セイト	生徒
ジツ	実
ネガウ	願う
ジッセキ	実績
セイセキ	成績
ヤケド	火傷
ケンチク	建築
カモツ	貨物
ツウカ	通貨
ウケツケ	受付
ウゴク	動く
コンラン	混乱
ゼン	全
マッタク	全く
ネッチュウ	熱中
スベテ	全て
フトル	太る
イケ	池
ツカマル	捕まる
ワガ	我が
ワレワレ	我々
キンム	勤務
ツウキン	通勤
タメ	為
ケツアツ	血圧
ワカイ	若い
チヂム	縮む
マゲル	曲げる
ダイメイシ	代名詞
カイ	貝
ウラガエス	裏返す
オンド	温度
キオン	気温
ザツオン	雑音
イツノマニカ	何時の間にか
ショウタイ	招待
アゲル	揚げる
アテハマル	当てはまる
アテハメル	当てはめる
シキ	四季
ヨウカ	八日
ヤッツ	八つ
ナツカシイ	懐かしい
コンナン	困難
ムイカ	六日
ムッツ	六つ
エイセイ	衛星
ホシ	星
カタナ	刀
タイコ	太鼓
キズ	傷
イロイロ	色々
ブラサゲル	ぶら下げる
センタク	選択
オモイツク	思い付く
ユウシュウ	優秀
チョシャ	著者
トクチョウ	特徴
ホウ	法
ザッシ	雑誌
ハタケ	畑
キンコ	金庫
ムス	蒸す
スイジョウキ	水蒸気
レイゾウコ	冷蔵庫
デカケル	出掛ける
セイ	性
ワルイ	悪い
ソウゾウ	想像
セイコウ	成功
ヨウ	用
カオリ	香り
ヒキカエス	引き返す
ケッセキ	欠席
タビ	度
ナベ	鍋
イチドニ	一度に
ヘンコウ	変更
トオイ	遠い
デンセン	伝染
ヒミツ	秘密
カエル	換える
ケイジ	刑事
サカ	坂
ナノカ	七日
ジコク	時刻
シンコク	深刻
ソコ	底
サンセイ	賛成
カンソウ	乾燥
イッチ	一致
オチツク	落ち着く
カカエル	抱える
ヤリトリ	やり取り
サル	猿
クリカエス	繰り返す
トリイレル	取り入れる
トレル	取れる
セメル	責める
フク	服
フクソウ	服装
マゼル	混ぜる
ハンザイ	犯罪
ハンニン	犯人
コン	紺
シタガウ	従う
ジェットキ	ジェット機
サイフ	財布
ヌノ	布
フトン	布団
オソロシイ	恐ろしい
タイラ	平ら
テラ	寺
ジイン	寺院
シタ	舌
キバン	基盤
ナラウ	習う
ムスコ	息子
コウモク	項目
サメル	覚める
エイエン	永遠
キョウヨウ	教養
イッショウケンメイ	一生懸命
ケン	県
ツヅク	続く
ツヅケル	続ける
キョダイ	巨大
ススメル	進める
シル	汁
ジシン	地震
ネガイ	願い
カイガ	絵画
キボウ	希望
クルシム	苦しむ
ケイヤク	契約
ショウスウ	小数
ブンスウ	分数
ヒッコム	引っ込む
カツヤク	活躍
ノボル	昇る
ハジメテ	初めて
ケイゴ	敬語
イタミ	痛み
ヨブン	余分
ノバス	伸ばす
イライ	依頼
ニガス	逃がす
コクセキ	国籍
ショセキ	書籍
オセン	汚染
ササエル	支える
シュクショウ	縮小
ダイイチ	第一
カイスイヨク	海水浴
カマ	釜
キンゾク	金属
ワライ	笑い
エガオ	笑顔
カテイ	仮定
タガイ	互い
ソウゴ	相互
セイレキ	西暦
ツク	点く
フクザツ	複雑
フクスウ	複数
ユウビンキョク	郵便局
ユウビン	郵便
スマセル	済ませる
ツケル	漬ける
ムチュウ	夢中
ヤクソク	約束
スマナイ	済まない
カク	書く
ナカ	仲
ナカマ	仲間
カキトリ	書取
エイヨウ	栄養
スイチョク	垂直
カス	貸す
ハラ	原
サキ	先
ユウカン	夕刊
ユウショク	夕食
ユウガタ	夕方
チエ	知恵
キジュン	規準
コクバン	黒板
イタ	板
レツ	列
レッシャ	列車
レットウ	列島
テラス	照らす
テル	照る
サワル	触る
キヨイ	清い
ハナス	離す
ムク	向く
ムケル	向ける
シャッキン	借金
アカンボウ	赤ん坊
キタナイ	汚い
タノモシイ	頼もしい
キセツ	季節
サマス	覚ます
ジュヨウ	需要
ホネ	骨
ジシャク	磁石
チュウシャ	注射
カル	刈る
ケイコウ	傾向
ソマツ	粗末
キンヨウ	金曜
ゲツヨウ	月曜
スイヨウ	水曜
ドヨウ	土曜
ニチヨウ	日曜
ヨウビ	曜日
オク	億
アソビ	遊び
アミモノ	編物
メイワク	迷惑
オモタイ	重たい
ユメ	夢
チカク	近く
ブッソウ	物騒
ハンコ	判子
ヨル	寄る
アメ	雨
コム	込む
イッショ	一緒
ウレル	売れる
アヤマル	謝る
アト	跡
ショウベン	小便
クミアワセ	組合せ
シラセ	知らせ
シラセル	知らせる
チュウシャジョウ	駐車場
デントウ	電灯
トウダイ	灯台
アリガタイ	有難い
シャショウ	車掌
ハミガキ	歯磨き
センタン	先端
アラシ	嵐
ハシ	端
ウンチン	運賃
ヤチン	家賃
ショウカイ	紹介
アオジロイ	青白い
ベツ	別
モノ	物
アンキ	暗記
キヌ	絹
クサ	草
マカセル	任せる
ヒク	引く
テッテイ	徹底
スンポウ	寸法
ノミモノ	飲み物
キチョウ	貴重
モトメル	求める
トコロ	所
ツギ	次
ジジョ	次女
ショウトツ	衝突
ツギツギニ	次々に
サイソク	催促
ショウテン	焦点
ヒトシイ	等しい
ウエル	植える
ウバウ	奪う
アマド	雨戸
ヤクス	訳す
カサイ	火災
フエ	笛
クラシ	暮らし
クレ	暮れ
カワセ	為替
ブンセキ	分析
スキキライ	好き嫌い
カカワル	係わる
カンタン	簡単
ウスメル	薄める
キンニク	筋肉
ニク	肉
ナットク	納得
ハライコム	払い込む
イショクジュウ	衣食住
ウチアワセ	打合せ
ショウ	章
ビョウ	秒
ブンショウ	文章
シンゾウ	心臓
カラ	殻
ホウリツ	法律
カクチ	各地
テアライ	手洗い
センメン	洗面
サソウ	誘う
ノム	飲む
ハジメニ	始めに
バッスル	罰する
カシダシ	貸し出し
シュウキョウ	宗教
シンチョウ	慎重
シキ	式
オクル	贈る
ヒッカカル	引っ掛かる
ヒビキ	響き
ニギル	握る
ボンチ	盆地
ミチジュン	道順
ウチュウ	宇宙
サケ	酒
ヌグ	脱ぐ
ユルイ	緩い
キンセン	金銭
ウエル	飢える
ウスイ	薄い
コウドウ	講堂
ショクドウ	食堂
サキホド	先程
ヒゲキ	悲劇
ソウサ	操作
タイソウ	体操
メイシン	迷信
オク	奥
ジュンジョウ	純情
シンダン	診断
スマイ	住まい
サツエイ	撮影
ジョウトウ	上等
タンジョウ	誕生
ナクス	無くす
ナクナル	無くなる
サライゲツ	再来月
クライ	位
ケッサク	傑作
アワテル	慌てる
ナガメル	眺める
カケル	掛ける
ウラミ	恨み
オク	置く
カンシャ	感謝
キュウコウ	休講
スウ	吸う
マッスグ	真っ直ぐ
ハヤル	流行る
サス	刺す
トマル	留まる
ハイシャ	歯医者
メイシ	名刺
シゲキ	刺激
トウチャク	到着
マモナク	間もなく
チラカル	散らかる
ダレ	誰
トウメイ	透明
メグル	巡る
スコシモ	少しも
オル	折る
カベ	壁
イネ	稲
ハナレル	放れる
カナシイ	悲しい
ハチ	鉢
トウゲ	峠
トリ	鳥
チョット	一寸
タンジュン	単純
リョウ	料
ミツメル	見詰める
メシ	飯
ヨユウ	余裕
タテル	建てる
ツウヤク	通訳
ゴウトウ	強盗
ヌスム	盗む
シバイ	芝居
キュウシュウ	吸収
コキュウ	呼吸
コテン	古典
ノビル	伸びる
サグル	探る
テンケイ	典型
ジテン	辞典
ナス	為す
ワキ	脇
オミヤゲ	お土産
サカラウ	逆らう
ワカス	沸かす
カンゴフ	看護婦
カンバン	看板
ヨス	止す
ヤム	止む
ヒキトメル	引き止める
ブタニク	豚肉
カンゲイ	歓迎
カワイソウ	可哀相
ベンキョウ	勉強
エンソウ	演奏
ワレル	割れる
ワリアイニ	割合に
サワギ	騒ぎ
ソウオン	騒音
キク	聞く
ジャグチ	蛇口
タイヨウ	太陽
クッツケル	くっ付ける
ブツケル	打付ける
オイコス	追い越す
ツケル	付ける
キヲツケル	気を付ける
コトヅケル	言付ける
ヤッツケル	やっ付ける
キレ	切れ
キレル	切れる
ウリキレ	売り切れ
ウリキレル	売り切れる
セツ	説
シマル	閉まる
ヨクバリ	欲張り
シンケン	真剣
メンキョ	免許
アリガトウ	有難う
サシミ	刺身
ホル	掘る
スイセン	推薦
チラス	散らす
トナリ	隣
スグレル	優れる
オンセン	温泉
イズミ	泉
ハンイ	範囲
ドレ	何れ
イネムリ	居眠り
フユ	冬
ナントナク	何となく
ヘイ	塀
クチビル	唇
カワ	皮
テツガク	哲学
ギョギョウ	漁業
チガイナイ	違いない
フンスイ	噴水
カイシャク	解釈
マネ	真似
カレル	枯れる
チョキン	貯金
クラス	暮らす
ゴウカ	豪華
ドナル	怒鳴る
ワスレモノ	忘れ物
オタク	お宅
ジュウタイ	渋滞
タイザイ	滞在
トマル	泊まる
ユズル	譲る
シツレイ	失礼
スキトオル	透き通る
ショウジョウ	症状
ヒキザン	引算
ワリザン	割り算
ハイザラ	灰皿
スベル	滑る
ガク	学
ソウコ	倉庫
ヒル	昼
ヒトリデニ	独りでに
モドル	戻る
ヒルマ	昼間
チュウショク	昼食
オチャ	お茶
チャ	茶
ソダテル	育てる
デンチュウ	電柱
ナゾ	謎
ビミョウ	微妙
ミサキ	岬
アライ	荒い
カタマル	固まる
フクロ	袋
コイ	濃い
マン	万
モウシワケナイ	申し訳ない
ツク	着く
ツケル	着ける
サクイン	索引
ソナエル	具える
ユキ	雪
シッピツ	執筆
フデ	筆
ボウサン	坊さん
マンネンヒツ	万年筆
リツ	率
クンレン	訓練
アビル	浴びる
ハイユウ	俳優
オサメル	納める
ジドウ	児童
ドウワ	童話
ツカレル	疲れる
タカラ	宝
トカス	溶かす
ガラ	柄
ムネ	胸
ソウゾウシイ	騒々しい
ムスメ	娘
スナ	砂
シオ	塩
アヤマリ	誤り
ゴカイ	誤解
シゼンニ	自然に
ウカブ	浮かぶ
カタヅケル	片付ける
ハヤク	早く
シュミ	趣味
ケッカン	欠陥
カエル	替える
ショサイ	書斎
ノリオクレル	乗り遅れる
オクレル	遅れる
ジュンジョ	順序
オトウト	弟
デシ	弟子
ゲジュン	下旬
ジョウジュン	上旬
チュウジュン	中旬
ウデ	腕
ハガキ	葉書
オテツダイサン	お手伝いさん
ツタエル	伝える
ヨウシ	要旨
カウ	飼う
ハタラク	働く
コウシャ	校舎
イナカ	田舎
オウベイ	欧米
ヒカク	比較
スキ	好き
スキズキ	好き好き
トコノマ	床の間
シュウカン	習慣
クワシイ	詳しい
カイツウ	開通
ミドリ	緑
ソンチョウ	尊重
イル	要る
テイコウ	抵抗
イワイ	祝い
シュクジツ	祝日
レイ	礼
フケル	更ける
マド	窓
マドグチ	窓口
ジュウドウ	柔道
ヤワラカイ	柔らかい
ヒサシブリ	久し振り
ハタ	旗
デアイ	出合い
オンブ	負んぶ
シジン	詩人
ムカシ	昔
チョウ	兆
ドノ	殿
マザル	混ざる
ツバサ	翼
ウシ	牛
ギュウニク	牛肉
テキ	敵
ミリョク	魅力
キライ	嫌い
イヤ	嫌
トメル	泊める
モシモ	若しも
ネマキ	寝間着
コオル	凍る
ケツエキ	血液
タネ	種
シキチ	敷地
カタ	肩
ハライモドス	払い戻す
フクメル	含める
コマル	困る
サンセイ	酸性
サンソ	酸素
アニ	兄
キョウダイ	兄弟
リョウ	量
オコル	怒る
ヒジョウニ	非常に
オヨグ	泳ぐ
タズネル	尋ねる
スイエイ	水泳
モヤス	燃やす
キソ	基礎
ユカイ	愉快
ソフ	祖父
ソボ	祖母
ヨウジ	幼児
セイスウ	整数
カギ	鍵
ニモツ	荷物
ウメ	梅
バカ	馬鹿
シュクハク	宿泊
ローマジ	ローマ字
アザ	字
ジビキ	字引
ボク	僕
サクラ	桜
ヌル	塗る
キノドク	気の毒
ハイク	俳句
モンク	文句
ジュミョウ	寿命
ヒカクテキ	比較的
サス	注す
ソウリダイジン	総理大臣
ダイジン	大臣
クサリ	鎖
クサル	腐る
ヒビク	響く
オカエリ	お帰り
セイソウ	清掃
ソウジ	掃除
クモ	雲
ショシンシャ	初心者
タテ	縦
ジュンサ	巡査
テンキヨホウ	天気予報
ツカレ	疲れ
ケイト	毛糸
イッシュン	一瞬
シュンカン	瞬間
ミナサン	皆さん
ヒトミ	瞳
キシャ	汽車
フンカ	噴火
イタル	至る
ツキアタリ	突き当たり
ホコリ	誇り
ノバス	延ばす
テンプ	添付
ヨゴス	汚す
スモウ	相撲
レイトウ	冷凍
ツイデ	序で
ホリ	堀
クヤシイ	悔しい
タクワエル	蓄える
ハラ	腹
ドンブリ	丼
キク	効く
ギュウニュウ	牛乳
ズウズウシイ	図々しい
ケムリ	煙
キンエン	禁煙
サライシュウ	再来週
サンナン	三男
ジュクゴ	熟語
フチ	縁
マル	丸
ボウダイ	膨大
コイ	恋
コイビト	恋人
シメキリ	締切
ハブク	省く
キュウ	旧
コンバン	今晩
ユウダチ	夕立
クルウ	狂う
マチアイシツ	待合室
カタヅク	片付く
コウガイ	郊外
トリカエル	取り替える
アルク	歩く
メズラシイ	珍しい
コシ	腰
キャクマ	客間
セキタン	石炭
オドリ	踊り
ニジ	虹
ショウギ	将棋
エンシュウ	円周
ボウケン	冒険
マイゴ	迷子
カンチガイ	勘違い
ユウキ	勇気
キカイ	機械
シツレン	失恋
コイシイ	恋しい
クセ	癖
マックロ	真っ黒
チカスイ	地下水
キオク	記憶
キョウフ	恐怖
イヌ	犬
ヤサイ	野菜
ミミ	耳
ツトメル	勤める
コシカケル	腰掛ける
サッキ	殺気
ユゲ	湯気
タンスウ	単数
ハカ	墓
ダマル	黙る
ヤブレル	破れる
フンイキ	雰囲気
タマゴ	卵
ミズウミ	湖
ノゾク	除く
オロス	降ろす
キツエン	喫煙
キッサテン	喫茶店
ショクタク	食卓
マツル	祭る
ナラベル	並べる
ホス	干す
ヒトゴミ	人込み
チョウテン	頂点
ムシ	虫
インサツ	印刷
カカル	掛かる
カビン	花瓶
サホウ	作法
ナラス	鳴らす
ハコ	箱
オジョウサン	お嬢さん
シュウ	集
トクシュ	特殊
シゲル	茂る
フリムク	振り向く
コウハイ	後輩
センパイ	先輩
アナ	穴
キミョウ	奇妙
ジマン	自慢
ハイケン	拝見
オンダン	温暖
ゲンサン	原産
ハクシュ	拍手
ツク	就く
ダイジョウブ	大丈夫
ツメ	爪
シンピン	新品
イバル	威張る
コウツウキカン	交通機関
コシカケ	腰掛け
ナミダ	涙
イヤガル	嫌がる
キュウカ	休暇
マゴ	孫
リョウジ	領事
カワイガル	可愛がる
カワイラシイ	可愛らしい
ヒトヤスミ	一休み
オヤスミ	お休み
ススメル	勧める
サワガシイ	騒がしい
オトル	劣る
アソコ	彼処
イッパンニ	一般に
ゲンコウ	原稿
ハズカシイ	恥ずかしい
エダ	枝
ナレル	慣れる
フロ	風呂
オカ	丘
ハシ	箸
マンガ	漫画
ゲンカン	玄関
シュウキン	集金
ニホン	日本
カクゴ	覚悟
ナクナル	亡くなる
ナクス	亡くす
キイロイ	黄色い
アツイ	暑い
タイボク	大木
サマス	冷ます
オンケイ	恩恵
ドク	毒
ホンダナ	本棚
ヤジルシ	矢印
オウフク	往復
バン	晩
ジョウハツ	蒸発
アウ	遭う
ヨソ	余所
サカサマ	逆様
マクラ	枕
カセグ	稼ぐ
ネムル	眠る
シメル	占める
シズム	沈む
イモウト	妹
カジョウ	過剰
コオリ	氷
オサナイ	幼い
ハナシカケル	話し掛ける
ナル	鳴る
セイショ	清書
ボウ	棒
テチョウ	手帳
ガイロン	概論
ケイヨウシ	形容詞
ソウリョウ	送料
ホンヤク	翻訳
クトウテン	句読点
サトウ	砂糖
アマヤカス	甘やかす
アネ	姉
ヤッカイ	厄介
シマイ	姉妹
カミ	髪
ショウボウショ	消防署
ヌク	抜く
ヌケル	抜ける
スル	刷る
ダトウ	妥当
ブンミャク	文脈
テンテン	転々
タキ	滝
コウタイ	交替
バステイ	バス停
マサツ	摩擦
ヨウチ	幼稚
カンジ	漢字
タマネギ	玉ねぎ
ミジメ	惨め
イト	糸
ベッソウ	別荘
スッパイ	酸っぱい
チカヂカ	近々
シュウゼン	修繕
サイノウ	才能
コウイン	工員
カタヨル	片寄る
アセ	汗
シン	芯
セイゼイ	精々
カンムリ	冠
ドウ	銅
カガミ	鏡
チラカス	散らかす
テンランカイ	展覧会
フエル	殖える
アクマ	悪魔
ムラサキ	紫
デンキ	伝記
アツカマシイ	厚かましい
アタタカイ	暖かい
ラン	欄
リャクス	略す
ウク	浮く
オイカケル	追い掛ける
アサイ	浅い
ビン	瓶
チョウコク	彫刻
カシコイ	賢い
タエズ	絶えず
ハダギ	肌着
ゼッタイニ	絶対に
ウソ	嘘
オダヤカ	穏やか
ムジュン	矛盾
オシイレ	押し入れ
シシャゴニュウ	四捨五入
ステル	捨てる
チカウ	誓う
ツリ	釣り
カン	缶
タガヤス	耕す
イス	椅子
オロス	卸す
ケショウ	化粧
アタタマル	暖まる
イクブン	幾分
タイソウ	大層
ナガメ	眺め
シンクウ	真空
カクウ	架空
ヨツカド	四つ角
アキル	飽きる
ツヤ	艶
オニ	鬼
ホル	彫る
ネマキ	寝巻
ハダ	肌
ヨウチエン	幼稚園
クツ	靴
ツル	釣る
ホトケ	仏
シンコウ	信仰
サビシイ	寂しい
ノル	載る
トカス	解かす
グウスウ	偶数
オコタル	怠る
ダン	段
センス	扇子
センプウキ	扇風機
ナサル	為さる
ヨメ	嫁
アサゴハン	朝御飯
アタタメル	温める
ニオイ	匂い
ドロ	泥
マネク	招く
コト	琴
イサマシイ	勇ましい
ヌウ	縫う
ロウカ	廊下
アラワス	著す
スミ	隅
アル	在る
スイジ	炊事
ヒロウ	拾う
ヘイボン	平凡
アカリ	灯
サマタゲル	妨げる
アヤシイ	怪しい
カケル	欠ける
ドウシ	動詞
サバク	砂漠
カゼ	風邪
ジンメイ	人命
ヨッパラウ	酔っ払う
オガム	拝む
ヒックリカエル	引っ繰り返る
マツリ	祭
エガク	描く
ムシアツイ	蒸し暑い
カワカス	乾かす
セイ	姓
ソロバン	算盤
ハナ	鼻
ツブ	粒
オマワリサン	お巡りさん
トオク	遠く
イダイ	偉大
シュウカク	収穫
フルエル	震える
ゴハン	ご飯
ヨコス	寄越す
ノリコシ	乗り越し
ウワサ	噂
コタイ	個体
アワタダシイ	慌ただしい
フレル	触れる
ボン	盆
チヂメル	縮める
チヂレル	縮れる
オレイ	お礼
カワ	河
エライ	偉い
ヨッパライ	酔っ払い
ナカナオリ	仲直り
ツクエ	机
セマイ	狭い
マネル	真似る
マンガイチ	万が一
メグマレル	恵まれる
ヨウモウ	羊毛
ヒフ	皮膚
トクチョウ	特長
ヒツジュヒン	必需品
サス	射す
フヤス	殖やす
カタムク	傾く
トドク	届く
トドケル	届ける
トケコム	溶け込む
アワレ	哀れ
キンヨウビ	金曜日
ゲツヨウビ	月曜日
スイヨウビ	水曜日
ドヨウビ	土曜日
ニチヨウビ	日曜日
ネムイ	眠い
モクヨウビ	木曜日
シリ	尻
マク	巻く
ユウユウ	悠々
テイネイ	丁寧
サイホウ	裁縫
センタク	洗濯
ネコ	猫
ビンヅメ	瓶詰
リョウ	寮
スイトウ	水筒
バカラシイ	馬鹿らしい
ニゴル	濁る
トウ	塔
カエッテ	却って
コタエル	答える
メイシ	名詞
オレル	折れる
シカシ	併し
トダナ	戸棚
キュウケイ	休憩
ヤク	焼く
ヤケル	焼ける
ソデ	袖
イノル	祈る
スイミン	睡眠
ボウシ	帽子
カシマ	貸間
ボクチク	牧畜
ヨウ	酔う
オシイ	惜しい
オクサン	奥さん
ジュンスイ	純粋
ヤワラカイ	軟らかい
ツメル	詰める
ズイブン	随分
タンジョウビ	誕生日
デムカエル	出迎える
トオリカカル	通り掛かる
カケザン	掛け算
ジョウダン	冗談
カナヅカイ	仮名遣い
フリガナ	振り仮名
オクリガナ	送り仮名
タンペン	短編
サク	裂く
シメル	湿る
ゾウリ	草履
ゼヒトモ	是非とも
ハダカ	裸
キップ	切符
シヘイ	紙幣
イド	緯度
ケイコウトウ	蛍光灯
タイクツ	退屈
ヤムヲエナイ	止むを得ない
サラ	皿
コウテイ	肯定
メシアガル	召し上がる
キカイ	器械
フゴウ	符号
オバ	叔母
ゴラク	娯楽
ウヤマウ	敬う
ユレル	揺れる
サムイ	寒い
オンチュウ	御中
カクレル	隠れる
フルサト	古里
スム	澄む
ミニクイ	醜い
シタガッテ	従って
ナマゴミ	生ごみ
クミ	組
ホホエム	微笑む
シバラク	暫く
アライ	粗い
オバ	伯母
コンゴウ	混合
サイジツ	祭日
ゲタ	下駄
フリコム	振り込む
ワスレル	忘れる
フク	吹く
ヤコウ	夜行
オドロク	驚く
ショウミ	正味
カネツ	加熱
イクツ	幾つ
デキル	出来る
セトモノ	瀬戸物
マタハ	又は
オイ	老い
センセイ	専制
ナグサメル	慰める
オテアライ	お手洗い
ボウハン	防犯
コウ	請う
トコヤ	床屋
シモ	霜
ユケツ	輸血
シオカライ	塩辛い
オイワイ	お祝い
ブシュ	部首
サラニ	更に
デキルダケ	出来るだけ
イッセイニ	一斉に
シク	敷く
アラスジ	粗筋
コボス	零す
オニイサン	お兄さん
フケツ	不潔
メッタニ	滅多に
オジイサン	お祖父さん
オバアサン	お祖母さん
マタ	又
モチ	餅
ハク	掃く
オオキナ	大きな
カガヤク	輝く
チョウ	長
デアイ	出会い
トブ	跳ぶ
オダイジニ	お大事に
ゼンジツ	前日
ナク	鳴く
ニクム	憎む
コゴエル	凍える
オナカ	お腹
ケムイ	煙い
ヤハリ	矢張り
シュゴ	主語
エサ	餌
オモチャ	玩具
ワケ	訳
オドル	踊る
トイアワセ	問い合わせ
イイツケル	言い付ける
トウキョウ	東京
クシ	櫛
ハネル	跳ねる
イタダク	頂く
ダメ	駄目
タビタビ	度々
マレ	稀
ミカケ	見掛け
イッテキマス	行って来ます
ゴウリュウ	合流
ユノミ	湯飲み
イチド	一度
トク	溶く
トケル	溶ける
サクセイ	作成
アタタメル	暖める
クモル	曇る
ユウベ	夕べ
ホガラカ	朗らか
ナク	泣く
イシ	意思
チク	地区
カゲ	陰
メイメイ	銘々
ヒザ	膝
チョゾウ	貯蔵
シュウジ	習字
スズシイ	涼しい
ケイコ	稽古
ホメル	褒める
ウラム	恨む
ウレユキ	売れ行き
カワク	乾く
ドウカク	同格
カエル	変える
ブツリガク	物理学
ハサム	挟む
ツギツギ	次々
オネエサン	お姉さん
ハナハダシイ	甚だしい
カンワ	漢和
ズミ	済み
ボッチャン	坊ちゃん
カンサイ	関西
メンドウクサイ	面倒臭い
ケンサク	検索
サク	咲く
オツリ	お釣り
ツリアウ	釣り合う
ヤカン	薬缶
カレシ	彼氏
シンロ	針路
ショク	職
サカバ	酒場
ニエル	煮える
ショクリョウヒン	食料品
クダク	砕く
クダケル	砕ける
ナニモ	何も
ナンベイ	南米
カシヤ	貸家
ガクジュツ	学術
カソクド	加速度
タマタマ	偶々
タク	宅
サイ	最
ミガク	磨く
タダ	只
ケイビ	警備
ハク	履く
ナイセン	内線
ケガ	怪我
ノウサンブツ	農産物
フクシ	副詞
スイテキ	水滴
リュウイキ	流域
ショクエン	食塩
ソウ	然う
タタム	畳む
シマ	縞
デコボコ	凸凹
ヌレル	濡れる
ムシロ	寧ろ
ダレカ	誰か
フモト	麓
ナマケル	怠ける
ワク	沸く
ウマイ	美味い
ハイ	灰
オカシ	お菓子
マメ	豆
イク	幾
ソクリョク	速力
ホシュウ	補習
ウカガウ	伺う
シンヤ	深夜
フクラマス	膨らます
モチアゲル	持ち上げる
ハル	貼る
イツ	何時
ニオウ	臭う
ニカイダテ	二階建て
クギ	釘
タク	炊く
スズム	涼む
ホカ	他
カイギシツ	会議室
ケンキュウシツ	研究室
ノド	喉
ツマリ	詰まり
アオグ	扇ぐ
ニクラシイ	憎らしい
ミナレル	見慣れる
ネボウ	寝坊
タンスイ	淡水
チュウショウ	抽象
コウザ	口座
セイショウネン	青少年
ズカン	図鑑
アキレル	呆れる
ケンシュウ	研修
チョウダイ	頂戴
ゼイタク	贅沢
カイカン	会館
シキュウ	支給
ナニナニ	何々
グタイ	具体
イタズラ	悪戯
ドウヨウ	童謡
ミマン	未満
ツモリ	積もり
ヒラガナ	平仮名
コウザ	講座
チョクリュウ	直流
シャレ	洒落
ジュウギョウ	従業
ソレ	其れ
カフンショウ	花粉症
コクオウ	国王
オウ	王
チョウタン	長短
カワク	渇く
ジョジョ	徐々
イクラ	幾ら
イキナリ	行き成り
ノウヤク	農薬
ナシ	無し
タバコ	煙草
ナラウ	倣う
タマラナイ	堪らない
ドウリョウ	同僚
シアガル	仕上がる
ビン	便
カヨウ	歌謡
スデニ	既に
トモニ	共に
ナオ	尚
ゼヒ	是非
アタリ	辺り
ミョウ	妙
キッカケ	切っ掛け
ナル	生る
ナンデモ	何でも
ヨソク	予測
フタ	蓋
コノゴロ	この頃
チカゴロ	近頃
フリダス	降り出す
ガッキュウ	学級
キュウ	級
チカン	痴漢
クライ	暗い
モラウ	貰う
フロシキ	風呂敷
ウラ	裏
ワク	湧く
タビ	足袋
コレ	此れ
マク	幕
エンリョナク	遠慮なく
テヌグイ	手拭い
スナワチ	即ち
タクサン	沢山
コウセキ	功績
コガス	焦がす
ハキケ	吐き気
ジバン	地盤
トガル	尖る
ケンメイ	懸命
オネガイシマス	お願いします
フゾク	附属
サシコム	差し込む
マサニ	正に
ヨウブン	養分
アンショウバンゴウ	暗証番号
オカゲサマデ	お蔭様で
マユゲ	眉毛
ゲキゾウ	激増
ハッシャ	発射
オヒル	お昼
カクジュウ	拡充
ドコ	何処
ヘコム	凹む
コウケン	貢献
イキグルシイ	息苦しい
ニオウ	匂う
コウチ	耕地
ハシゴ	梯子
アコガレル	憧れる
ヌラス	濡らす
ジュウ	銃
モノスゴイ	物凄い
タタク	叩く
カイテキ	快適
サワヤカ	爽やか
レイテン	零点
マク	蒔く
カッコ	括弧
ケル	蹴る
スイハンキ	炊飯器
ムク	剥く
カシコマリマシタ	畏まりました
アキ	明き
カム	噛む
ナデル	撫でる
タダシ	但し
アフレル	溢れる
ソル	剃る
ショジュン	初旬
ソロウ	揃う
ソロエル	揃える
ジャガイモ	ジャガ芋
フク	拭く
モウカル	儲かる
モウケル	儲ける
ウタ	詩
ノウド	濃度
タメル	溜める
タマル	溜まる
アキラメル	諦める
イッセイ	一斉
ゼツメツ	絶滅
オヨギ	泳ぎ
ツルス	吊るす
ツル	吊る
カグ	嗅ぐ
ワビル	詫びる
ゴゾンジ	ご存知
タツ	発つ
ノセル	載せる
イケナイ	行けない
オシャベリ	お喋り
カモシレナイ	かも知れない
クッツク	くっ付く
コレカラ	此れから
シキリニ	頻りに
ズラス	滑らす
ソシテ	然して
ソノウチ	その内
ソレカラ	其れから
ソレデ	其れで
ソレトモ	其れ共
ソレニ	其れに
ダラシナイ	だらし無い
トコロガ	所が
トンデモナイ	とんでも無い
ナゼナラ	何故なら
ブツカル	打つかる
モシ	若し
モシカシタラ	若しかしたら
モシカスルト	若しかすると
ヤッパリ	矢っ張り
ヤル	遣る
ガラス	硝子
コンクリート	混凝土
バネ	発条
ヨル	因る
ヌルイ	温い
クダラナイ	下らない
イツマデモ	何時までも
イツモ	何時も
ドコカ	何処か
ヤカマシイ	喧しい
マルデ	丸で
ウレシイ	嬉しい
アナタ	貴方
ヨロシイ	宜しい
ヨロシク	宜しく
アクビ	欠伸
ミットモナイ	見っともない
クレル	呉れる
クレグレモ	呉れ呉れも
ゴメン	御免
オメデトウ	お目出度う
ココ	此処
コンニチハ	今日は
コンバンハ	今晩は
サヨウナラ	左様なら
スミマセン	済みません
シマウ	仕舞う
シカル	叱る
トックニ	疾っくに
イトコ	従兄弟
トコロデ	所で
シッポ	尻尾
マサカ	真逆
ツイニ	遂に
スゴイ	凄い
ナルベク	成るべく
ナルホド	成程
アイニク	生憎
マズ	先ず
チギル	千切る
ヨウヤク	漸く
ソレデハ	其れでは
ソレデモ	其れでも
ソコデ	其処で
ワザト	態と
イタダキマス	頂きます
オトナシイ	大人しい
チョウド	丁度
シャベル	喋る
カミソリ	剃刀
トウトウ	到頭
トン	屯
ドウシテ	如何して
ドウシテモ	如何しても
ウルサイ	煩い
カブセル	被せる
オイシイ	美味しい
フト	不図
マズイ	不味い
シカモ	然も
オヨソ	凡そ
マダ	未だ
メチャクチャ	目茶苦茶
サスガ	流石
コボレル	零れる
イツデモ	何時でも
コノ	此の
アラユル	有らゆる
アルイハ	或いは
オカズ	御数
オヤツ	お八つ
カナリ	可也
シッカリ	確り
セッカク	折角
ノンキ	暢気
ヒドイ	酷い
マスマス	益々
メデタイ	目出度い
セイ	所為
ツケル	点ける
アレコレ	彼此
オハヨウ	お早う
ソウシテ	然うして
タマニ	偶に
ヒッコシ	引越し
ナガイ	永い
ヒザシ	陽射
ショクリョウ	食糧
ヨウガン	溶岩
ウリアゲ	売上
タンコウ	炭鉱
ヨロコブ	慶ぶ
ツケル	浸ける
キレイ	綺麗
アル	或る
ニクイ	憎い
クヤム	悔やむ
セン	栓
ゴランニナル	ご覧になる
ハサマル	挟まる
カワイソウ	可哀想
ジョウキ	蒸気
ハナミズ	鼻水
セリフ	台詞
カンソウキ	乾燥機
ショウユ	しょう油
モト	基
ボウヤ	坊や
ナカミ	中味
メザマシ	目覚し
スム	清む
ソッチョク	卒直
カレラ	彼等
カシ	菓子
シハライ	支払
タマ	弾
フルマウ	振舞う
ヨク	良く
ウタ	歌(う)
トオ	通(る)
ハズ	外(す)
ハナシア	話し合(う)
ウケト	受け取(る)
アラタ	改(める)
サダ	定(める)
マワ	回(す)
トイア	問い合(わせる)
デア	出会(う)
ナリタ	成り立(つ)
ウゴ	動(かす)
オモイダ	思い出(す)
ミナオ	見直(す)
タモ	保(つ)
クダ	下(る)
アラソ	争(う)
ウミダ	生み出(す)
カゾ	数(える)
ウリダ	売り出(す)
シリア	知り合(う)
ヒキア	引き上(げる)
ヒキサ	引き下(げる)
ウタガ	疑(う)
サダ	定(まる)
モチ	用(いる)
カマ	構(う)
クワ	加(わる)
ハズ	外(れる)
ハナ	話(す)
ハジ	始(める)
シタ	親(しむ)
クバ	配(る)
ホウ	報(じる)
ヒキト	引き取(る)
クワ	加(える)
トウ	投(じる)
スス	進(む)
ワタ	渡(す)
ノゾ	望(む)
タノ	楽(しむ)
フカ	深(める)
ウツ	移(す)
ワカ	別(れる)
エン	演(ずる)
ヒキダ	引き出(す)
ノコ	残(る)
ハナ	放(つ)
ミハナ	見放(す)
ハカ	図(る)
タメ	試(す)
イソ	急(ぐ)
ミキワ	見極(める)
コノ	好(む)
ホドコ	施(す)
トビダ	飛び出(す)
フカ	深(まる)
オサ	収(まる)
オサ	収(める)
マチウ	待ち受(ける)
ウツ	写(る)
ヒッパ	引っ張(る)
ソナ	備(わる)
ヤクニタ	役に立(つ)
ソダ	育(つ)
ヤブ	破(る)
マチカマ	待ち構(える)
モウシア	申し上(げる)
トリケ	取り消(す)
ソソ	注(ぐ)
オイダ	追い出(す)
ノボ	登(る)
クミコ	組み込(む)
オチコ	落ち込(む)
モヨオ	催(す)
メイ	命(じる)
フリカエ	振り返(る)
モウ	申(す)
ウツ	写(す)
ツラ	連(ねる)
マチノゾ	待ち望(む)
クル	苦(しめる)
アマ	余(る)
ハイ	入(る)
マナ	学(ぶ)
ネラ	狙(う)
ヨビダ	呼び出(す)
ツク	作(る)
ソナ	備(える)
ツノ	募(る)
キン	禁(じる)
ナオ	治(る)
ヨロコ	喜(ぶ)
ヨロコ	喜(ばす)
ヨビカ	呼び掛(ける)
シメキ	締め切(る)
スク	救(う)
ミダ	乱(れる)
ヨソオ	装(う)
ソコ	損(なう)
タヨ	頼(る)
ウラギ	裏切(る)
ミア	見合(わせる)
キザ	刻(む)
ムカ	迎(える)
トリコ	取り込(む)
ウチコ	打ち込(む)
コワ	壊(す)
ヒキツ	引き継(ぐ)
タタカ	闘(う)
ロン	論(じる)
ショウ	生(じる)
オコナ	行(う)
タチヨ	立ち寄(る)
クイコ	食い込(む)
コワ	壊(れる)
オソ	恐(れる)
ノリカ	乗り換(える)
マニア	間に合(う)
オウ	応(ずる)
マニア	間に合(わせる)
アバ	暴(れる)
ミノ	実(る)
ドウ	動(じる)
アラワ	表(す)
ロン	論(ずる)
エラ	選(ぶ)
カン	感(ずる)
ミア	見上(げる)
トオリス	通り過(ぎる)
ウチア	打ち上(げる)
タカ	高(まる)
タカ	高(める)
ハジ	始(まる)
フンバ	踏ん張(る)
ツクリア	作り上(げる)
カヨ	通(う)
タオ	倒(す)
ムク	報(いる)
ヒッコ	引っ越(す)
キド	気取(る)
ノリコ	乗り越(える)
ヤワ	和(らぐ)
ヤワ	和(らげる)
マジ	交(わる)
フセ	防(ぐ)
ノボ	上(る)
ツト	務(める)
ハカ	測(る)
ツヨ	強(める)
ハラ	払(う)
ミチガ	見違(える)
マド	惑(わす)
オモ	思(う)
アタ	与(える)
タビダ	旅立(つ)
ウケイ	受け入(れる)
カク	隠(す)
エン	演(じる)
ナガビ	長引(く)
トリダ	取り出(す)
ナヅ	名付(ける)
ヒキオ	引き起(こす)
シル	記(す)
メダ	目立(つ)
コロ	転(がす)
コロ	転(がる)
クイサ	食い下(がる)
アツカ	扱(う)
ムス	結(ぶ)
デア	出合(う)
ココロ	試(みる)
チガ	違(う)
サワ	騒(ぐ)
ココロエ	心得(る)
ヨリカ	寄り掛(かる)
キワダ	際立(つ)
アラワ	現(す)
マサ	勝(る)
ヒロ	広(める)
アタタ	温(まる)
カサ	重(ねる)
カンガ	考(える)
タタカ	戦(う)
アツ	集(まる)
アツ	集(める)
ワラ	笑(う)
モト	基(づく)
ツカ	使(う)
イタ	致(す)
ウチケ	打ち消(す)
モチナオ	持ち直(す)
クダ	下(す)
ミト	認(める)
タト	例(える)
オカ	侵(す)
マイ	参(る)
ウツ	映(る)
ノガ	逃(れる)
カン	感(じる)
タチア	立ち上(がる)
シメ	示(す)
リキ	力(む)
ヒロ	広(がる)
モド	戻(す)
オシ	教(える)
カザ	飾(る)
ツイ	費(やす)
トリハズ	取り外(す)
キヅ	気付(く)
タシ	確(かめる)
クイト	食い止(める)
ハコ	運(ぶ)
アラワ	現(れる)
アラ	現(われる)
シラ	調(べる)
ヒロ	広(まる)
ヒロ	広(げる)
シイ	仕入(れる)
オウ	応(じる)
アジ	味(わう)
オモ	重(んじる)
マチガ	間違(える)
マチガ	間違(う)
ミワタ	見渡(す)
タチナオ	立ち直(る)
ミオ	見下(ろす)
ニカヨ	似通(う)
デキア	出来上(がる)
トリク	取り組(む)
シリア	知合(う)
ナガ	流(す)
アズ	預(ける)
シン	信(じる)
ナヤ	悩(む)
カエ	返(す)
キニイ	気に入(る)
ホウ	放(る)
フク	含(む)
オドロ	驚(かす)
ヒキア	引上(げる)
ヒキウ	引き受(ける)
ヒキサ	引下(げる)
トリア	取り上(げる)
ナゴ	和(む)
カタ	語(る)
モノガタ	物語(る)
イトナ	営(む)
トトノ	整(う)
オモイア	思い上(がる)
ヒキ	率(いる)
ウケト	受け止(める)
ミオク	見送(る)
オク	送(る)
ワリダ	割り出(す)
モウ	設(ける)
ナオ	直(す)
タク	託(す)
マワ	回(る)
ヤト	雇(う)
クラ	比(べる)
アズ	預(かる)
ツヨ	強(まる)
ソナ	供(える)
コトワ	断(る)
シボ	絞(る)
オソ	教(わる)
ヒキト	引取(る)
フク	膨(れる)
ウケツ	受け付(ける)
ミツ	見付(かる)
ヒカ	光(る)
コロ	転(ぶ)
ツウ	通(じる)
キラ	嫌(う)
スワ	座(る)
カナ	悲(しむ)
タテナオ	立て直(す)
アラタ	改(まる)
タズ	訪(ねる)
サシア	差し上(げる)
ハバ	阻(む)
ノコ	残(す)
オサ	治(まる)
オサ	治(める)
タチド	立ち止(まる)
カエ	反(す)
ヒキダ	引出(す)
トリツ	取り次(ぐ)
タス	助(ける)
オモイキ	思い切(る)
ジョウ	乗(じる)
ハヤ	早(める)
ハカ	計(る)
カギ	限(る)
ツラ	連(なる)
イイダ	言い出(す)
ミス	見過(ごす)
アオ	青(ざめる)
ウチア	打ち明(ける)
ツタ	伝(わる)
タダ	正(す)
クイチガ	食い違(う)
カキナオ	書き直(す)
トビオ	飛び降(りる)
タス	助(かる)
サシダ	差し出(す)
アラワ	表(れる)
ハヤ	早(まる)
オオ	覆(う)
クミタ	組み立(てる)
メイ	命(ずる)
チカヅ	近付(ける)
ウシナ	失(う)
ゾン	存(じる)
クワダ	企(てる)
ハゲ	励(ます)
サガ	探(す)
マモ	守(る)
モウシデ	申し出(る)
カサ	重(なる)
オヨ	及(ぼす)
オモイナオ	思い直(す)
サシツカ	差し支(える)
ナラ	並(ぶ)
サケ	叫(ぶ)
アラ	表(わす)
ウツ	映(す)
ヒキハナ	引き離(す)
オド	脅(す)
オボ	覚(える)
アラ	現(わす)
オイツ	追い付(く)
モリア	盛り上(げる)
ヤクダ	役立(つ)
ワリア	割り当(てる)
フク	膨(らむ)
ツッパ	突っ張(る)
アユミヨ	歩み寄(る)
ヨコギ	横切(る)
ウケモ	受け持(つ)
アラ	洗(う)
ウラナ	占(う)
イキワタ	行き渡(る)
ホコ	誇(る)
ウツ	移(る)
ホウム	葬(る)
メザ	目指(す)
イワ	祝(う)
オヨ	及(ぶ)
カツ	担(ぐ)
ツケクワ	付け加(える)
オトズ	訪(れる)
ウッタ	訴(える)
ハナ	離(れる)
オギナ	補(う)
トダ	途絶(える)
メグリア	巡り会(う)
ハナ	放(す)
オシツ	押し付(ける)
マチア	待ち合(わせる)
ナオ	直(る)
カエ	帰(る)
ヒソ	潜(む)
トオ	通(す)
コロ	殺(す)
シン	信(ずる)
ナオ	治(す)
モリア	盛り上(がる)
ガンバ	頑張(る)
ツキア	付き合(う)
ニナ	担(う)
ヒキツ	引き付(ける)
クギ	区切(る)
ツッコ	突っ込(む)
ノリマワ	乗り回(す)
ミクラ	見比(べる)
ナガ	流(れる)
サズ	授(ける)
シア	仕上(げる)
サガ	捜(す)
ワズラ	患(う)
ワタ	渡(る)
ハシ	走(る)
ハズ	弾(む)
ツカ	捕(まえる)
キソ	競(う)
ヤス	休(む)
ハカ	量(る)
ツキア	突き当(たる)
トリア	取上(げる)
ハナシコ	話し込(む)
ヨコ	横(たわる)
ミマ	見舞(う)
キン	禁(ずる)
モチナオ	持直(す)
ナグ	殴(る)
キメツ	決め付(ける)
ヒキシ	引き締(める)
モチコ	持ち込(む)
オイコ	追い込(む)
ミハ	見張(る)
ツク	造(る)
ミカギ	見限(る)
ヘダ	隔(てる)
メザ	目覚(める)
テツダ	手伝(う)
タダヨ	漂(う)
ヒキウ	引受(ける)
カイシ	買い占(める)
ニア	似合(う)
トリヨ	取り寄(せる)
ヒキオコ	引き起(す)
ワリキ	割り切(る)
オキア	起き上(がる)
クズ	崩(す)
アマ	余(す)
カブ	被(る)
ユル	緩(む)
タノ	頼(む)
シタ	仕立(てる)
カエ	反(る)
アソ	遊(ぶ)
マル	丸(める)
マヨ	迷(う)
ユル	許(す)
ウチケ	打消(す)
ミウシナ	見失(う)
ヌケダ	抜け出(す)
クイト	食止(める)
カラ	絡(む)
ヨゴ	汚(れる)
ヨワ	弱(まる)
ヨワ	弱(める)
キワ	極(まる)
ウケツ	受け継(ぐ)
ノゾ	臨(む)
チカヨ	近寄(る)
ツト	努(める)
カタ	固(める)
ヒエコ	冷え込(む)
カコ	囲(む)
セオ	背負(う)
セマ	迫(る)
ハリキ	張り切(る)
クズ	崩(れる)
カエ	帰(す)
ショウ	生(ずる)
シズ	静(まる)
タオ	倒(れる)
ミツ	見付(ける)
ウケタマワ	承(る)
モウシコ	申し込(む)
トビコ	飛び込(む)
コト	異(なる)
ヒラ	開(く)
シハラ	支払(う)
ケズ	削(る)
シバ	縛(る)
ネガ	願(う)
ウゴ	動(く)
フト	太(る)
ツカ	捕(まる)
チヂ	縮(む)
ウラガエ	裏返(す)
ブラサ	ぶら下(げる)
オモイツ	思い付(く)
デカ	出掛(ける)
ヒキカエ	引き返(す)
オチツ	落ち着(く)
カカ	抱(える)
クリカエ	繰り返(す)
トリイ	取り入(れる)
シタガ	従(う)
ナラ	習(う)
ツヅ	続(く)
ツヅ	続(ける)
スス	進(める)
クル	苦(しむ)
ヒッコ	引っ込(む)
ノボ	昇(る)
ササ	支(える)
サワ	触(る)
ハナ	離(す)
アヤマ	謝(る)
クル	包(む)
マカ	任(せる)
モト	求(める)
ウバ	奪(う)
ヤク	訳(す)
カカ	係(わる)
ウス	薄(める)
ハライコ	払い込(む)
サソ	誘(う)
オク	贈(る)
ヒッカ	引っ掛(かる)
ニギ	握(る)
アワ	慌(てる)
ナガ	眺(める)
ハヤ	流行(る)
オド	脅(かす)
メグ	巡(る)
ハナ	放(れる)
ミツ	見詰(める)
ヌス	盗(む)
サグ	探(る)
サカ	逆(らう)
ヒキト	引き止(める)
クッツ	くっ付(ける)
ブツ	打付(ける)
オイコ	追い越(す)
キヲツ	気を付(ける)
コトヅ	言付(ける)
ヤッツ	やっ付(ける)
ウリキ	売り切(れる)
スグ	優(れる)
ドナ	怒鳴(る)
ユズ	譲(る)
スキトオ	透き通(る)
スベ	滑(る)
モド	戻(る)
ソダ	育(てる)
カタ	固(まる)
ソナ	具(える)
オサ	納(める)
ツカ	疲(れる)
カタヅ	片付(ける)
ノリオク	乗り遅(れる)
オク	遅(れる)
ツタ	伝(える)
ハタラ	働(く)
コオ	凍(る)
ハライモド	払い戻(す)
フク	含(める)
コマ	困(る)
オコ	怒(る)
オヨ	泳(ぐ)
タズ	尋(ねる)
クサ	腐(る)
ヒビ	響(く)
イタ	至(る)
ヨゴ	汚(す)
タクワ	蓄(える)
ハブ	省(く)
クル	狂(う)
カタヅ	片付(く)
トリカ	取り替(える)
アル	歩(く)
ツト	勤(める)
コシカ	腰掛(ける)
ダマ	黙(る)
ヤブ	破(れる)
ノゾ	除(く)
マツ	祭(る)
ナラ	並(べる)
シゲ	茂(る)
フリム	振り向(く)
イバ	威張(る)
イヤ	嫌(がる)
カワイ	可愛(がる)
スス	勧(める)
オト	劣(る)
カセ	稼(ぐ)
ネム	眠(る)
シズ	沈(む)
ハナシカ	話し掛(ける)
アマ	甘(やかす)
カタヨ	片寄(る)
リャク	略(す)
オイカ	追い掛(ける)
チカ	誓(う)
タガヤ	耕(す)
オロ	卸(す)
アタタ	暖(まる)
オコタ	怠(る)
アタタ	温(める)
マネ	招(く)
アラワ	著(す)
ヒロ	拾(う)
サマタ	妨(げる)
ヨッパラ	酔っ払(う)
オガ	拝(む)
イダ	抱(く)
ヒックリカエ	引っ繰り返(る)
エガ	描(く)
カワ	乾(かす)
フル	震(える)
ヨコ	寄越(す)
チヂ	縮(める)
チヂ	縮(れる)
マネ	真似(る)
メグ	恵(まれる)
カタム	傾(く)
トド	届(く)
トド	届(ける)
トケコ	溶け込(む)
ニゴ	濁(る)
コタ	答(える)
イノ	祈(る)
デムカ	出迎(える)
トオリカ	通り掛(かる)
シメ	湿(る)
メシア	召し上(がる)
ウヤマ	敬(う)
カク	隠(れる)
ホホエ	微笑(む)
フリコ	振り込(む)
ワス	忘(れる)
オドロ	驚(く)
デキ	出来(る)
ナグサ	慰(める)
コボ	零(す)
カガヤ	輝(く)
ニク	憎(む)
コゴ	凍(える)
オド	踊(る)
イイツ	言い付(ける)
イタダ	頂(く)
アタタ	暖(める)
クモ	曇(る)
ウラ	恨(む)
カワ	乾(く)
ハサ	挟(む)
ツリア	釣り合(う)
クダ	砕(く)
クダ	砕(ける)
ミガ	磨(く)
タタ	畳(む)
ナマ	怠(ける)
ウカガ	伺(う)
フク	膨(らます)
モチア	持ち上(げる)
ニオ	臭(う)
スズ	涼(む)
アオ	扇(ぐ)
ミナ	見慣(れる)
アキ	呆(れる)
カワ	渇(く)
ナラ	倣(う)
シア	仕上(がる)
フリダ	降り出(す)
モラ	貰(う)
トガ	尖(る)
サシコ	差し込(む)
ヘコ	凹(む)
ニオ	匂(う)
アコガ	憧(れる)
タタ	叩(く)
アフ	溢(れる)
ソロ	揃(う)
ソロ	揃(える)
モウ	儲(かる)
モウ	儲(ける)
アキラ	諦(める)
クッツ	くっ付(く)
シマ	仕舞(う)
シカ	叱(る)
チギ	千切(る)
シャベ	喋(る)
カブ	被(せる)
コボ	零(れる)
ヨロコ	慶(ぶ)
ゴラン	ご覧(になる)
ハサ	挟(まる)
フルマ	振舞(う)
